家 <br> kyá <br>	<br> Suffix: class or type of grouping <br> <br> <hr> <br>  <br>  
界 <br> ká <br>	<br> Suffix: sphere, boundary, a type of grouping <br> <br> <hr> <br>  <br>  
世代 <br> sz de <br>	<br> Suffix: an age, a race, a generation or sphere, boundary, type of grouping <br> <br> <hr> <br>  <br>  
時代 <br> zz de <br>	<br> 1. Suffix: an age, a race, a generation (but covering a shorter period)<div>2.&nbsp; An epoch</div> <br> <br> <hr> <br>  <br>  
思想 <br> sz siáng <br>	<br> Suffix: theory <br> <br> <hr> <br>  <br>  
主義 <br> tsû nyi <br>	<br> Suffix: a policy <br> <br> <hr> <br>  <br>  
術 <br> dseh <br>	<br> Suffix: art, method <br> <br> <hr> <br>  <br>  
政治家 <br> tsung dsz kyá <br>	<br> Politicians <br> <br> <hr> <br>  <br>  
演說家 <br> in söh kyá <br>	<br> Lecturers <br> <br> <hr> <br>  <br>  
哲學家 <br> tseh yáh kyá <br>	<br> Philosophers <br> <br> <hr> <br>  <br>  
"創作家 <br> ts'ong tsoh kyá <br>"	<br> Inventors <br> <br> <hr> <br>  <br>  
飛行家 <br> fi yung kyá <br>	<br> Aviators <br> <br> <hr> <br>  <br>  
格致家 <br> kuh tsz kyá <br>	<br> Scientists <br> <br> <hr> <br>  <br>  
電學家 <br> din yáh kyá <br>	<br> Electricians <br> <br> <hr> <br>  <br>  
專門家 <br> tsen mung kyá <br>	<br> Specialists or experts <br> <br> <hr> <br>  <br>  
著作家 <br> tsû tsoh kyá <br>	<br> Authors <br> <br> <hr> <br>  <br>  
"美術家 <br> m'e dseh kyá <br>"	<br> Artists <br> <br> <hr> <br>  <br>  
外交家 <br> we kyau kyá <br>	<br> Diplomats <br> <br> <hr> <br>  <br>  
理財家 <br> li dse kyá <br>	<br> Financiers <br> <br> <hr> <br>  <br>  
動物界 <br> dúng veh ká <br>	<br> Animal kingdom <br> <br> <hr> <br>  <br>  
植物界 <br> dsuh veh ká <br>	<br> Vegetable kingdom <br> <br> <hr> <br>  <br>  
遊牧世代 <br> yeu móh sz de <br>	<br> Nomads, the pastoral age <br> <br> <hr> <br>  <br>  
專制時代 <br> tsen tsz zz de <br>	<br> Age of tyrants <br> <br> <hr> <br>  <br>  
人道主義 <br> zung dau tsû nyi <br>	<br> Humanitarianism policy <br> <br> <hr> <br>  <br>  
"鐵血主義 <br> t'ih hyöh tsû nyi <br>"	<br> Blood and iron policy <br> <br> <hr> <br>  <br>  
素食主義 <br> sú zuh tsû nyi <br>	<br> Vegetarianism from hygiene rather than from religious motives <br> <br> <hr> <br>  <br>  
羣衆主義 <br> gyün tsúng tsû nyi <br>	<br> Gregariousness (friendly and social policy) <br> <br> <hr> <br>  <br>  
個人主義 <br> kuh nyung tsû nyi <br>	<br> Policy of individuality and originality <br> <br> <hr> <br>  <br>  
報復主義 <br> pau vóh tsû nyi <br>	<br> Policy of revenge and vengeance <br> <br> <hr> <br>  <br>  
排外主義 <br> bá we tsû nyi <br>	<br> Anti-foreign policy <br> <br> <hr> <br>  <br>  
從新主義 <br> dsúng sing tsû nyi <br>	<br> Policy of readiness to grasp new ideas <br> <br> <hr> <br>  <br>  
飛行術 <br> fi yung dseh <br>	<br> Aviation <br> <br> <hr> <br>  <br>  
"催眠術 <br> ts'öi min dseh <br>"	<br> Hypnotism <br> <br> <hr> <br>  <br>  
愚弄術 <br> nyü lúng dseh <br>	<br> Deception <br> <br> <hr> <br>  <br>  
寫真術 <br> siá tsung dseh <br>	<br> Art of painting <br> <br> <hr> <br>  <br>  
革命思想 <br> kuh ming sz siáng <br>	<br> Revolutionary conviction <br> <br> <hr> <br>  <br>  
宗教思想 <br> tsúng kyau sz siáng <br>	<br> Religious interest <br> <br> <hr> <br>  <br>  
睡獅 <br> dsöi sz <br>	<br> Old China (sleeping lion) <br> <br> <hr> <br>  <br>  
睡獅醒 <br> dsöi sz sing <br>	<br> New China (the sleeping lion aroused) <br> <br> <hr> <br>  <br>  
"優勝劣敗 <br> y'eu sung lih be <br>"	<br> 1. The superior nation will conquer (the survival of the fittest)<div>2. Natural selection</div> <br> <br> <hr> <br>  <br>  
弱肉強食 <br> záh zóh gyáng zuh <br>	<br> The superior nation will conquer (the weak is meat, the strong will eat) <br> <br> <hr> <br>  <br>  
染指 <br> zen tsz <br>	<br> To intermeddle (finger in the pie) <br> <br> <hr> <br>  <br>  
垂涎 <br> dsöi yin <br>	<br> Desirous of obtaining advantage (Mouth watering) <br> <br> <hr> <br>  <br>  
蠶食 <br> zen zuh <br>	<br> Piecemeal dismemberment of empire (to eat as a silk worm does a leaf, nibbling bit by bit from the outside edge) <br> <br> <hr> <br>  <br>  
"鯨吞 <br> gyung t'ung <br>"	<br> Seizure of the empire as a whole (to eat as a whale does, swallowing whole) <br> <br> <hr> <br>  <br>  
"虎視 <br> h'ú zz <br>"	"<br> To stealthily watch one's opportunity (a tiger watching his prey) <br> <br> <hr> <br>  <br>  "
瓜分 <br> kwó fung <br>	<br> To divide the empire (to cut up a melon) <br> <br> <hr> <br>  <br>  
"豆剖 <br> deu p'eu <br>"	<br> To sever the empire in two as north and south (to split the bean into two halves) <br> <br> <hr> <br>  <br>  
執牛耳 <br> tseh nyeu rh <br>	<br> To have the supremacy (to take hold of the ear of the ox) <br> <br> <hr> <br>  <br>  
熱血 <br> nyih hyöh <br>	<br> Warm hearted (affectionate and kind) <br> <br> <hr> <br>  <br>  
"熱血派 <br> nyih hyöh p'á <br>"	<br> Enthusiasts or zealots <br> <br> <hr> <br>  <br>  
涼血 <br> liáng hyöh <br>	<br> Cold hearted (unfriendly and uncaring) <br> <br> <hr> <br>  <br>  
"涼血派 <br> liáng hyöh p'á <br>"	<br> The indifferent class, the unsympathetic <br> <br> <hr> <br>  <br>  
狼心 <br> long sing <br>	"<br> An evil heart (a wolf's heart) <br> <br> <hr> <br>  <br>  "
狗肺 <br> keu fi <br>	"<br> An evil heart (a dog's lungs) <br> <br> <hr> <br>  <br>  "
牛馬 <br> nyeu mó <br>	<br> Slaves, servile labour (cow and horse) <br> <br> <hr> <br>  <br>  
本源 <br> pung nyön <br>	<br> Cause (root of tree and source of river) <br> <br> <hr> <br>  <br>  
皮毛 <br> bi mau <br>	<br> Skin deep, only an external show (hide and hair) <br> <br> <hr> <br>  <br>  
關鍵 <br> kwan gyin <br>	<br> Pivot, essential part (spring of lock) <br> <br> <hr> <br>  <br>  
機關 <br> kyi kwan <br>	<br> Pivot, essential part (main spring) <br> <br> <hr> <br>  <br>  
隔膜 <br> kuh móh <br>	<br> Separation due to lack of understanding (diaphragm) <br> <br> <hr> <br>  <br>  
風潮 <br> fúng dsau <br>	<br> Disturbance (wind and tide) <br> <br> <hr> <br>  <br>  
枝葉 <br> tsz yih <br>	<br> Unimportant details, non essentials (twig and leaf) <br> <br> <hr> <br>  <br>  
根本 <br> kung pung <br>	<br> The essentials (the root) <br> <br> <hr> <br>  <br>  
過渡 <br> kú dú <br>	<br> Unsettled, transitional (while crossing the ferry) <br> <br> <hr> <br>  <br>  
"響應 <br> hyáng y'ung <br>"	<br> To respond, to follow immediately, as echo follows sound (sound echo) <br> <br> <hr> <br>  <br>  
"影響 <br> y'ung hyáng <br>"	<br> Effect, result (shadow and sound) <br> <br> <hr> <br>  <br>  
"虎頭蛇尾 <br> h'ú deu zó vi <br>"	<br> Great pretensions but little fulfilment, end in a fizzle (head of a tiger but tail of a snake) <br> <br> <hr> <br>  <br>  
"狐假虎威 <br> hú kyá h'ú w'e <br>"	"<br> Reliance on a stronger power, to bluff (the fox depending on the tiger's prowess) <br> <br> <hr> <br>  <br>  "
棋分 <br> gyi fung <br>	<br> To separate, as one arranges the two sets of chessmen <br> <br> <hr> <br>  <br>  
一盤散沙 <br> ih ben san só <br>	<br> Segregated, unconsolidated, detached, disjunction, separation (a plate of sand) <br> <br> <hr> <br>  <br>  
政事 <br> tsung zz <br>	<br> Government affairs <br> <br> <hr> <br>  <br>  
政府 <br> tsung fú <br>	<br> The headquarters of government, the head of any government, the administration <br> <br> <hr> <br>  <br>  
"政體 <br> tsung t'i <br>"	<br> Form of government <br> <br> <hr> <br>  <br>  
"專制政體 <br> tsen tsz tsung t'i <br>"	<br> Absolute or unlimited monarchy <br> <br> <hr> <br>  <br>  
"單一國體 <br> tan ih kóh t'i <br>"	<br> Centralised form of government <br> <br> <hr> <br>  <br>  
"君主政體 <br> kyün tsû tsung t'i <br>"	<br> Monarchical form of government <br> <br> <hr> <br>  <br>  
"共和政體 <br> kúng hú tsung t'i <br>"	<br> Republican form of government <br> <br> <hr> <br>  <br>  
"立憲政體 <br> lih hyin tsung t'i <br>"	<br> Constitutional form of government <br> <br> <hr> <br>  <br>  
"聯邦政體 <br> lin pong tsung t'i <br>"	<br> Confederate or federal form of government <br> <br> <hr> <br>  <br>  
君主國 <br> kyün tsû kóh <br>	<br> Monarchy <br> <br> <hr> <br>  <br>  
民主國 <br> ming tsû kóh <br>	<br> Republic <br> <br> <hr> <br>  <br>  
"政治團體 <br> tsung dsz dön t'i <br>"	<br> The body politic <br> <br> <hr> <br>  <br>  
憲法 <br> hyin fah <br>	<br> Constitution <br> <br> <hr> <br>  <br>  
政界 <br> tsung ká <br>	<br> Government circles <br> <br> <hr> <br>  <br>  
司事 <br> sz zz <br>	<br> The executive <br> <br> <hr> <br>  <br>  
"中央政府 <br> tsúng y'áng tsung fú <br>"	<br> The central government <br> <br> <hr> <br>  <br>  
摄政王 <br> suh tsung wong <br>	<br> The Prince regent <br> <br> <hr> <br>  <br>  
皇室 <br> wong suh <br>	<br> Imperial family (intermediate) <br> <br> <hr> <br>  <br>  
"貴戚 <br> kwe ts'ih <br>"	<br> Imperial clan <br> <br> <hr> <br>  <br>  
貴族 <br> kwe dsóh <br>	<br> Imperial clan <br> <br> <hr> <br>  <br>  
管界 <br> kwen ká <br>	<br> The official class, officials <br> <br> <hr> <br>  <br>  
國務院 <br> kóh vú yön <br>	<br> 1. Ministers of state<div>2. The cabinet</div> <br> <br> <hr> <br>  <br>  
總理 <br> tsúng li <br>	<br> Prime minister, premier <br> <br> <hr> <br>  <br>  
國務總長 <br> kóh vú tsúng tsáng <br>	<br> Prime minister, premier <br> <br> <hr> <br>  <br>  
內閣大臣 <br> ne koh dá dsung <br>	<br> Prime minister, premier <br> <br> <hr> <br>  <br>  
總內閣 <br> tsúng ne koh <br>	<br> Prime minister, premier <br> <br> <hr> <br>  <br>  
各部總長 <br> koh bú tsúng tsáng <br>	<br> Cabinet officers, the cabinet <br> <br> <hr> <br>  <br>  
各部首領 <br> koh bú seu ling <br>	<br> Cabinet officers, the cabinet <br> <br> <hr> <br>  <br>  
禮部<div><br></div><div>吏部<br></div> <br> li bú <br>	<br> a. Board of rites or ceremonies<div><br></div><div>b. Board of civil office</div> <br> <br> <hr> <br>  <br>  
法部 <br> fah bú <br>	<br> Board of justice <br> <br> <hr> <br>  <br>  
度支部 <br> dú tsz bú <br>	<br> Board of revenue or finance <br> <br> <hr> <br>  <br>  
陸軍部 <br> lóh kyün bú <br>	<br> 1. Board of army (war office)<div><div>2. Board of war (army)</div></div> <br> <br> <hr> <br>  <br>  
"海軍部 <br> h'e kyün bú <br>"	<br> Board of navy (admiralty)&nbsp; <br> <br> <hr> <br>  <br>  
農工商部 <br> núng kúng song bú <br>	<br> Board of agriculture, labour and commerce <br> <br> <hr> <br>  <br>  
學部 <br> yáh bú <br>	<br> Board of education <br> <br> <hr> <br>  <br>  
郵傳部 <br> yeu dsen bú <br>	<br> Board of posts and communications <br> <br> <hr> <br>  <br>  
外務部 <br> we vú bú <br>	<br> Board of foreign affairs <br> <br> <hr> <br>  <br>  
外交部 <br> we kyau bú <br>	<br> Board of foreign affairs, foreign office <br> <br> <hr> <br>  <br>  
內務部 <br> ne vú bú <br>	<br> Board of the interior or home affairs <br> <br> <hr> <br>  <br>  
財政部 <br> dse tsung bú <br>	<br> Board of finance <br> <br> <hr> <br>  <br>  
教育部 <br> kyau yóh bú <br>	<br> Board of education <br> <br> <hr> <br>  <br>  
司法部 <br> sz fah bú <br>	<br> 1. Board of justice<div>2. Judiciary USA</div> <br> <br> <hr> <br>  <br>  
農林部 <br> núng ling bú <br>	<br> Board of agriculture and forestry <br> <br> <hr> <br>  <br>  
工商部 <br> kúng song bú <br>	<br> Board of industry and commerce <br> <br> <hr> <br>  <br>  
"交通部 <br> kyau t'úng bú <br>"	<br> Board of communications <br> <br> <hr> <br>  <br>  
理藩部 <br> li van bú <br>	<br> Colonial office <br> <br> <hr> <br>  <br>  
國會 <br> kóh we <br>	<br> National assembly, parliament (China) <br> <br> <hr> <br>  <br>  
議院<div><br></div><div>議員<br></div> <br> nyi yön <br>	<br> a. Parliament (England)<div><br></div><div>b. Member of parliament</div> <br> <br> <hr> <br>  <br>  
行政部 <br> yung tsung bú <br>	<br> Executive USA <br> <br> <hr> <br>  <br>  
立法部 <br> lih fah bú <br>	<br> Legislative USA <br> <br> <hr> <br>  <br>  
議會 <br> nyi we <br>	<br> Congress USA <br> <br> <hr> <br>  <br>  
元老院 <br> nyön lau yön <br>	<br> Senate USA <br> <br> <hr> <br>  <br>  
代議院 <br> de nyi yön <br>	<br> House of representatives USA <br> <br> <hr> <br>  <br>  
資政院 <br> tsz tsung yön <br>	<br> National assembly (under the Manchus) <br> <br> <hr> <br>  <br>  
諮議局 <br> tsz nyi gyóh <br>	<br> Provincial assembly (under the Manchus) <br> <br> <hr> <br>  <br>  
臨時政府 <br> ling zz tsung fú <br>	<br> Provisional government <br> <br> <hr> <br>  <br>  
"大總統 <br> dá tsúng t'úng <br>"	<br> President <br> <br> <hr> <br>  <br>  
"臨時大總統 <br> ling zz dá tsúng t'úng <br>"	<br> Provisional or acting president <br> <br> <hr> <br>  <br>  
巡撫 <br> dsing fú <br>	<br> Governor of province (imperial government) <br> <br> <hr> <br>  <br>  
都督 <br> tú tóh <br>	<br> 1. Military governor of province (Republican government)<div>2. Commander in chief (Three Kingdoms)</div> <br> <br> <hr> <br>  <br>  
"勸業道 <br> ky'ön nyih dau <br>"	<br> Superintendent of industries <br> <br> <hr> <br>  <br>  
"參謀總長 <br> ts'en meu tsúng tsáng <br>"	<br> Chief of general staff <br> <br> <hr> <br>  <br>  
秘議 <br> pi nyi <br>	<br> Privy council (private advisors) <br> <br> <hr> <br>  <br>  
"參議院 <br> ts'en nyi yön <br>"	<br> Deliberative assembly, senate <br> <br> <hr> <br>  <br>  
代表 <br> de piau <br>	<br> Representative, delegate <br> <br> <hr> <br>  <br>  
國權 <br> kóh gyön <br>	<br> State rights <br> <br> <hr> <br>  <br>  
"國課 <br> kóh k'ú <br>"	<br> Budget, treasury <br> <br> <hr> <br>  <br>  
預計 <br> yü kyi <br>	<br> Budget, treasury <br> <br> <hr> <br>  <br>  
預算表 <br> yü sön piau <br>	<br> Budget, treasury <br> <br> <hr> <br>  <br>  
國債 <br> kóh tsá <br>	<br> National debts <br> <br> <hr> <br>  <br>  
"借款 <br> tsiá kw'en <br>"	<br> Loan <br> <br> <hr> <br>  <br>  
"出口稅 <br> ts'eh k'eu söi <br>"	<br> Export tax <br> <br> <hr> <br>  <br>  
"入口稅 <br> zeh k'eu söi <br>"	<br> Import tax <br> <br> <hr> <br>  <br>  
"昭信票 <br> tsau sing p'iau <br>"	<br> Government bonds <br> <br> <hr> <br>  <br>  
稅務司 <br> söi vú sz <br>	<br> Commissioner of customs <br> <br> <hr> <br>  <br>  
經濟 <br> kyung tsi <br>	<br> Economics, finances <br> <br> <hr> <br>  <br>  
"國家專賣品 <br> kóh kyá tsen má p'ing <br>"	<br> Government monopoly <br> <br> <hr> <br>  <br>  
幣 <br> bi <br>	<br> Money, wealth, currency (originally meaning silk) <br> <br> <hr> <br>  <br>  
"通寶 <br> t'úng pau <br>"	<br> Moeny, currency <br> <br> <hr> <br>  <br>  
"鑄幣廠 <br> tsû bi ts'áng <br>"	<br> Mint <br> <br> <hr> <br>  <br>  
"造幣廠 <br> zau bi ts'áng <br>"	<br> Imperial mint at Peking <br> <br> <hr> <br>  <br>  
銀幣局 <br> nyung bi gyóh <br>	<br> Silver mint <br> <br> <hr> <br>  <br>  
銀元局 <br> nyung yön gyóh <br>	<br> Silver mint <br> <br> <hr> <br>  <br>  
銅元局 <br> dúng yön gyóh <br>	<br> Copper mint <br> <br> <hr> <br>  <br>  
銅元 <br> dúng yön <br>	<br> Copper cent equal to ten cents or less <br> <br> <hr> <br>  <br>  
銅板 <br> dúng pan <br>	<br> Copper cent equal to ten cents or less <br> <br> <hr> <br>  <br>  
角 <br> koh <br>	<br> A dime (ten cents) <br> <br> <hr> <br>  <br>  
"礦務 <br> kw'ong vú <br>"	<br> Mining <br> <br> <hr> <br>  <br>  
"採掘權 <br> ts'e gyöh gyön <br>"	<br> The right to exploit mines <br> <br> <hr> <br>  <br>  
森林 <br> sung ling <br>	<br> Forestry, afforestation <br> <br> <hr> <br>  <br>  
農事試驗場 <br> núng zz sz nyin dsáng <br>	<br> Government experimental farm <br> <br> <hr> <br>  <br>  
郵政局 <br> yeu tsung gyóh <br>	<br> The imperial post, a post office <br> <br> <hr> <br>  <br>  
信箱 <br> sing siáng <br>	<br> Letter box <br> <br> <hr> <br>  <br>  
郵費 <br> yeu fi <br>	<br> Postage <br> <br> <hr> <br>  <br>  
"快信 <br> kw'á sing <br>"	<br> Express or special delivery <br> <br> <hr> <br>  <br>  
信號 <br> sing hau <br>	<br> Postage stamp <br> <br> <hr> <br>  <br>  
"郵票 <br> yeu p'iau <br>"	<br> 1. Postage stamp<div>2. Postal money order</div> <br> <br> <hr> <br>  <br>  
掛號 <br> kwó hau <br>	<br> To register a letter <br> <br> <hr> <br>  <br>  
迴折 <br> we tseh <br>	<br> Return receipt <br> <br> <hr> <br>  <br>  
單掛號 <br> tan kwó hau <br>	<br> Registration, simple <br> <br> <hr> <br>  <br>  
雙掛號 <br> song kwó hau <br>	<br> Registration with return receipt <br> <br> <hr> <br>  <br>  
國事犯 <br> kóh zz van <br>	<br> Political criminal <br> <br> <hr> <br>  <br>  
擾亂治安 <br> zau lön dsz ön <br>	<br> To disturb the peace <br> <br> <hr> <br>  <br>  
保護治安 <br> pau hú dsz ön <br>	<br> To preserve the peace <br> <br> <hr> <br>  <br>  
"警察 <br> kyung ts'ah <br>"	<br> Police <br> <br> <hr> <br>  <br>  
巡警 <br> dsing kyung <br>	<br> Police <br> <br> <hr> <br>  <br>  
"警察局 <br> kyung ts'ah gyóh <br>"	<br> Police station <br> <br> <hr> <br>  <br>  
巡警局 <br> dsing kyung gyóh <br>	<br> Police station <br> <br> <hr> <br>  <br>  
巡警道 <br> dsing kyung dau <br>	<br> Chief or superintendent of police <br> <br> <hr> <br>  <br>  
"偵探 <br> tsung t'en <br>"	<br> 1. Detective<div>2. To reconnoitre (reconnaissance)</div> <br> <br> <hr> <br>  <br>  
"探訪 <br> t'en fong <br>"	<br> Detective <br> <br> <hr> <br>  <br>  
密偵員 <br> mih tsung yön <br>	<br> Secret service, detective <br> <br> <hr> <br>  <br>  
暗查員 <br> en dsó yön <br>	<br> Secret service <br> <br> <hr> <br>  <br>  
國旗 <br> kóh gyi <br>	<br> National flag <br> <br> <hr> <br>  <br>  
龍旗 <br> lúng gyi <br>	<br> The flag of the Manchu dynasty (dragon flag) <br> <br> <hr> <br>  <br>  
五色旗 <br> ng suh gyi <br>	<br> Revolutionary flag (five colour flag) <br> <br> <hr> <br>  <br>  
挂國旗 <br> kwó kóh gyi <br>	<br> To raise or fly the national flag <br> <br> <hr> <br>  <br>  
下半旗 <br> hau pen gyi <br>	<br> Flag at half mast <br> <br> <hr> <br>  <br>  
公佈法律 <br> kúng pú fah lih <br>	<br> To promulgate laws <br> <br> <hr> <br>  <br>  
執行法律 <br> tseh yung fah lih <br>	<br> To execute laws <br> <br> <hr> <br>  <br>  
宣戰 <br> sin tsen <br>	<br> To declare war <br> <br> <hr> <br>  <br>  
"條約 <br> diau y'áh <br>"	<br> 1. To make treaties<div>2. Conditions</div> <br> <br> <hr> <br>  <br>  
宣告戒嚴 <br> sin kau kyá nyin <br>	<br> To proclaim martial law <br> <br> <hr> <br>  <br>  
命令 <br> ming ling <br>	<br> Presidential mandate <br> <br> <hr> <br>  <br>  
副署 <br> fú dsü <br>	<br> To countersign <br> <br> <hr> <br>  <br>  
"簽押 <br> ts'in ah <br>"	<br> To affix a signature <br> <br> <hr> <br>  <br>  
"選派 <br> sin p'á <br>"	<br> To select and commission <br> <br> <hr> <br>  <br>  
"調遣 <br> diau ky'in <br>"	<br> To commission to office <br> <br> <hr> <br>  <br>  
"委任 <br> w'e zung <br>"	<br> To commission to office <br> <br> <hr> <br>  <br>  
位置 <br> we tsz <br>	<br> To station (an official) <br> <br> <hr> <br>  <br>  
"裁撤 <br> dse ts'eh <br>"	<br> To remove from office, to cashier <br> <br> <hr> <br>  <br>  
受彈劾 <br> zeu dan heh <br>	<br> To be impeached <br> <br> <hr> <br>  <br>  
任期 <br> zung gyi <br>	<br> Term of office <br> <br> <hr> <br>  <br>  
內閣 <br> ne koh <br>	<br> The cabinet <br> <br> <hr> <br>  <br>  
民政長 <br> ming tsung tsáng <br>	<br> 1. Civil governor of province<div>2. Chief of civil administration</div> <br> <br> <hr> <br>  <br>  
軍政長 <br> kyün tsung tsáng <br>	<br> Chief of military administration <br> <br> <hr> <br>  <br>  
"參政 <br> ts'en tsung <br>"	<br> To take part in politics <br> <br> <hr> <br>  <br>  
門羅主義 <br> mung lú tsû nyi <br>	<br> The Monroe doctrine <br> <br> <hr> <br>  <br>  
列強均勢 <br> lih gyáng kyün sz <br>	<br> Balance of power <br> <br> <hr> <br>  <br>  
以金爲本位 <br> i kyung we pung we <br>	<br> To adopt a gold standard <br> <br> <hr> <br>  <br>  
軍務 <br> kyün vú <br>	<br> Military affairs <br> <br> <hr> <br>  <br>  
軍界 <br> kyün ká <br>	<br> The army <br> <br> <hr> <br>  <br>  
軍政府 <br> kyün tsung fú <br>	<br> Military headquarters <br> <br> <hr> <br>  <br>  
司令 <br> sz ling <br>	<br> Officer in command <br> <br> <hr> <br>  <br>  
常備軍 <br> dsáng be kyün <br>	<br> Standing army <br> <br> <hr> <br>  <br>  
兵隊 <br> ping de <br>	<br> Soldiers <br> <br> <hr> <br>  <br>  
精兵 <br> tsing ping <br>	<br> Trained soldiers <br> <br> <hr> <br>  <br>  
聯軍 <br> lin kyün <br>	<br> Allied forces, the allies <br> <br> <hr> <br>  <br>  
禁衛軍 <br> kyung we kyün <br>	<br> Imperial body guard <br> <br> <hr> <br>  <br>  
陸軍 <br> lóh kyün <br>	<br> Land forces, the army <br> <br> <hr> <br>  <br>  
"海軍 <br> h'e kyün <br>"	<br> The navy <br> <br> <hr> <br>  <br>  
"炮隊 <br> p'au de <br>"	<br> The artillery <br> <br> <hr> <br>  <br>  
"鐵政局 <br> t'ih tsung gyóh <br>"	<br> The artillery department <br> <br> <hr> <br>  <br>  
馬隊 <br> mó de <br>	<br> The cavalry <br> <br> <hr> <br>  <br>  
馬兵 <br> mó ping <br>	<br> The cavalry <br> <br> <hr> <br>  <br>  
步隊 <br> bú de <br>	<br> The infantry <br> <br> <hr> <br>  <br>  
步兵 <br> bú ping <br>	<br> The infantry <br> <br> <hr> <br>  <br>  
工程兵 <br> kúng dsung ping <br>	<br> Sappers and miners <br> <br> <hr> <br>  <br>  
先鋒隊 <br> sin fúng de <br>	<br> The vanguard, the forefront army <br> <br> <hr> <br>  <br>  
前隊 <br> dsin de <br>	<br> The vanguard, the forefront army <br> <br> <hr> <br>  <br>  
前敵 <br> dsin dih <br>	<br> An enemy directly in front <br> <br> <hr> <br>  <br>  
後隊 <br> heu de <br>	<br> The rear army <br> <br> <hr> <br>  <br>  
軍樂隊 <br> kyün yáh de <br>	<br> Military band <br> <br> <hr> <br>  <br>  
小鼓號 <br> siau kú hau <br>	<br> Military band <br> <br> <hr> <br>  <br>  
排 <br> bá <br>	<br> Squad of twenty five soldiers <br> <br> <hr> <br>  <br>  
隊 <br> de <br>	<br> Company of four bá, hundred men <br> <br> <hr> <br>  <br>  
營 <br> yung <br>	<br> Two de, or two hundred men <br> <br> <hr> <br>  <br>  
標 <br> piau <br>	<br> Four yung, or eight hundred men <br> <br> <hr> <br>  <br>  
協 <br> yah <br>	<br> Two piau, or one thousand six hundred men <br> <br> <hr> <br>  <br>  
鎮 <br> tsung <br>	<br> Two yah, or three thousand two hundred men <br> <br> <hr> <br>  <br>  
巡防隊 <br> dsing bong de <br>	<br> Scouts <br> <br> <hr> <br>  <br>  
新兵 <br> sing ping <br>	<br> Recruits <br> <br> <hr> <br>  <br>  
巡哨個 <br> dsing sau kuh <br>	<br> Patrol <br> <br> <hr> <br>  <br>  
巡行 <br> dsing yung <br>	<br> To patrol <br> <br> <hr> <br>  <br>  
"游緝隊 <br> yeu ts'ih de <br>"	<br> Military watch <br> <br> <hr> <br>  <br>  
兵餉 <br> ping hyáng <br>	<br> Rations <br> <br> <hr> <br>  <br>  
餉銀 <br> hyáng nyung <br>	<br> Soldiers pay <br> <br> <hr> <br>  <br>  
"軍款 <br> kyün kw'en <br>"	<br> Soldiers pay <br> <br> <hr> <br>  <br>  
軍械 <br> kyün ye <br>	<br> Military arms <br> <br> <hr> <br>  <br>  
"軍火 <br> kyün h'ú <br>"	<br> Ammunition <br> <br> <hr> <br>  <br>  
"炮子 <br> p'au tsz <br>"	<br> Cannon ball <br> <br> <hr> <br>  <br>  
"炮彈 <br> p'au dan <br>"	<br> Cannon ball <br> <br> <hr> <br>  <br>  
"開花彈子 <br> k'e hwó dan tsz <br>"	<br> Cannon shell <br> <br> <hr> <br>  <br>  
"炸炮 <br> tsó p'au <br>"	<br> Mortar for firing shell <br> <br> <hr> <br>  <br>  
炸彈 <br> tsó dan <br>	<br> Bomb <br> <br> <hr> <br>  <br>  
"機關炮 <br> kyi kwan p'au <br>"	<br> Machine gun, maxim gun <br> <br> <hr> <br>  <br>  
"快槍 <br> kw'á ts'iáng <br>"	<br> Magazine gun, rapid firing gun <br> <br> <hr> <br>  <br>  
"毛瑟槍 <br> mau seh ts'iáng <br>"	<br> Mauser rifle <br> <br> <hr> <br>  <br>  
無煙藥 <br> vú in yáh <br>	<br> Smokeless powder <br> <br> <hr> <br>  <br>  
"刺刀 <br> ts'z tau <br>"	<br> Bayonet <br> <br> <hr> <br>  <br>  
"槍刺 <br> ts'iáng ts'z <br>"	<br> Bayonet <br> <br> <hr> <br>  <br>  
地雷 <br> di le <br>	<br> Subterranean mine <br> <br> <hr> <br>  <br>  
水雷 <br> sz le <br>	<br> Submarine mine <br> <br> <hr> <br>  <br>  
"導火線 <br> dau h'ú sin <br>"	<br> Fuse <br> <br> <hr> <br>  <br>  
炸子 <br> tsó tsz <br>	<br> Bomb <br> <br> <hr> <br>  <br>  
"炮船 <br> p'au zen <br>"	<br> Battleship, gunboat <br> <br> <hr> <br>  <br>  
"魚雷艇 <br> yü le t'ing <br>"	<br> Torpedo boat <br> <br> <hr> <br>  <br>  
運送船 <br> yün súng zen <br>	<br> Transport boat <br> <br> <hr> <br>  <br>  
"放空槍 <br> fong k'úng ts'iáng <br>"	<br> To fire blank cartridges <br> <br> <hr> <br>  <br>  
光報 <br> kwong pau <br>	<br> To signal by lights <br> <br> <hr> <br>  <br>  
燈語 <br> tung nyü <br>	<br> To signal by lights <br> <br> <hr> <br>  <br>  
"照海燈 <br> tsau h'e tung <br>"	<br> Search light <br> <br> <hr> <br>  <br>  
"孔明燈 <br> k'úng ming tung <br>"	<br> Search light (Zhuge liang light) <br> <br> <hr> <br>  <br>  
諸葛燈 <br> tsû köh tung <br>	<br> Search light (Zhuge liang light) <br> <br> <hr> <br>  <br>  
根據 <br> kung kyü <br>	<br> Strategic front <br> <br> <hr> <br>  <br>  
調兵 <br> diau ping <br>	<br> To summon soldiers <br> <br> <hr> <br>  <br>  
陸軍期 <br> lóh kyün gyi <br>	<br> The army flag <br> <br> <hr> <br>  <br>  
"海軍期 <br> h'e kyün gyi <br>"	<br> The navy flag <br> <br> <hr> <br>  <br>  
軍令 <br> kyün ling <br>	<br> Martial law <br> <br> <hr> <br>  <br>  
"軍令槍斃 <br> kyün ling ts'iáng bi <br>"	<br> Executed by martial law (shot) <br> <br> <hr> <br>  <br>  
軍衣 <br> kyün i <br>	<br> Army uniform <br> <br> <hr> <br>  <br>  
軍裝 <br> kyün tsong <br>	<br> Army uniform <br> <br> <hr> <br>  <br>  
肩章 <br> kyin tsáng <br>	"<br> An officers' epaulette <br> <br> <hr> <br>  <br>  "
肩牌 <br> kyin bá <br>	"<br> A privates' epaulette <br> <br> <hr> <br>  <br>  "
袖章 <br> zieu tsáng <br>	<br> Stripes on sleeve to indicate rank <br> <br> <hr> <br>  <br>  
領章 <br> ling tsáng <br>	<br> Marks on collar to indicate rank <br> <br> <hr> <br>  <br>  
舉手禮 <br> kyü seu li <br>	<br> Military salute <br> <br> <hr> <br>  <br>  
"口令 <br> k'eu ling <br>"	<br> Watch word, password <br> <br> <hr> <br>  <br>  
行囊 <br> háng nong <br>	"<br> Soldier's knap sack (sleeping rug, kit and strapped on the back) <br> <br> <hr> <br>  <br>  "
血戰 <br> hyöh tsen <br>	<br> Bloody battle <br> <br> <hr> <br>  <br>  
"槍林彈雨 <br> ts'iáng ling dan yü <br>"	<br> Bloody battle (forest of guns and rain of bullets) <br> <br> <hr> <br>  <br>  
調停 <br> diau ding <br>	<br> To intervene in the interests of peace <br> <br> <hr> <br>  <br>  
停戰 <br> ding tsen <br>	<br> Cessation of hostilities, armistice, truce <br> <br> <hr> <br>  <br>  
奬勵金 <br> tsiáng li kyung <br>	<br> Bounty, as to soldiers <br> <br> <hr> <br>  <br>  
賞格 <br> song káh <br>	<br> Bounty, as to soldiers <br> <br> <hr> <br>  <br>  
寶星 <br> pau sing <br>	<br> Decoration <br> <br> <hr> <br>  <br>  
勳章 <br> hyün tsáng <br>	<br> Decoration <br> <br> <hr> <br>  <br>  
徽章 <br> hwe tsáng <br>	<br> Military medal <br> <br> <hr> <br>  <br>  
"退伍 <br> t'e ú <br>"	<br> To disband soldiers <br> <br> <hr> <br>  <br>  
叛兵 <br> ben ping <br>	<br> Mutinying soldiers <br> <br> <hr> <br>  <br>  
亂兵 <br> lön ping <br>	<br> Mutinying soldiers <br> <br> <hr> <br>  <br>  
兵變 <br> ping pin <br>	<br> To mutiny <br> <br> <hr> <br>  <br>  
民軍 <br> ming kyün <br>	"<br> Revolutionary army (people's army) <br> <br> <hr> <br>  <br>  "
革軍 <br> káh kyün <br>	<br> Revolutionary army <br> <br> <hr> <br>  <br>  
光復軍 <br> kwong vóh kyün <br>	<br> Revolutionary army (returning to the light army) <br> <br> <hr> <br>  <br>  
南軍 <br> nen kyün <br>	<br> Revolutionary army (of the south) <br> <br> <hr> <br>  <br>  
滿軍 <br> men kyün <br>	<br> Manchu army <br> <br> <hr> <br>  <br>  
"清軍 <br> ts'ing kyün <br>"	<br> Manchu army (of the Qing) <br> <br> <hr> <br>  <br>  
北軍 <br> póh kyün <br>	<br> Manchu army (of the north) <br> <br> <hr> <br>  <br>  
律法 <br> lih fah <br>	<br> The law <br> <br> <hr> <br>  <br>  
"控訴院 <br> k'úng sú yön <br>"	<br> Apellate court, supreme court, the court of cassation <br> <br> <hr> <br>  <br>  
大審院 <br> dá sung yön <br>	<br> Appellate court, supreme court, the court of cassation <br> <br> <hr> <br>  <br>  
大理院 <br> dá li yön <br>	<br> Appellate court, supreme court, the court of cassation <br> <br> <hr> <br>  <br>  
"審判廳 <br> sung p'en t'ing <br>"	<br> Law court <br> <br> <hr> <br>  <br>  
"檢察廳 <br> kyin ts'ah t'ing <br>"	<br> Law court <br> <br> <hr> <br>  <br>  
"檢察員 <br> kyin ts'ah yön <br>"	<br> Procurator (magistrate and investigator) <br> <br> <hr> <br>  <br>  
"裁判官 <br> dse p'en kwen <br>"	<br> Judge <br> <br> <hr> <br>  <br>  
司法官 <br> sz fah kwen <br>	<br> Judge <br> <br> <hr> <br>  <br>  
法官 <br> fah kwen <br>	<br> Judge <br> <br> <hr> <br>  <br>  
辯護士 <br> bin hú zz <br>	<br> Lawyer <br> <br> <hr> <br>  <br>  
律法師 <br> lih fah sz <br>	<br> Lawyer <br> <br> <hr> <br>  <br>  
律師會 <br> lih sz we <br>	<br> Body of lawyers, the legal profession <br> <br> <hr> <br>  <br>  
呈法吏 <br> dsung fah li <br>	<br> Clerks of recieving and despatching office <br> <br> <hr> <br>  <br>  
行政官 <br> yung tsung kwen <br>	<br> Civil administrator <br> <br> <hr> <br>  <br>  
檢驗員 <br> kyin nyin yön <br>	<br> Coroner <br> <br> <hr> <br>  <br>  
會審<div><br></div><div>衛生<br></div> <br> we sung <br>	<br> a. Mixed court<div><br></div><div>b. Hygiene</div> <br> <br> <hr> <br>  <br>  
證書 <br> tsung sû <br>	<br> Testimony, evidence <br> <br> <hr> <br>  <br>  
"鐵證 <br> t'ih tsung <br>"	<br> Incontrovertible evidence <br> <br> <hr> <br>  <br>  
"上控 <br> zong k'úng <br>"	<br> To appeal to a higher court <br> <br> <hr> <br>  <br>  
民事訴訟 <br> ming zz sú dsúng <br>	<br> Civil suit <br> <br> <hr> <br>  <br>  
刑事訴訟 <br> yung zz sú dsúng <br>	<br> Criminial suit <br> <br> <hr> <br>  <br>  
"科料 <br> k'ú liau <br>"	<br> A fine, or to fine <br> <br> <hr> <br>  <br>  
"押獄 <br> y'ah nyóh <br>"	<br> To imprison <br> <br> <hr> <br>  <br>  
自新所 <br> zz sing sú <br>	<br> Reformatory (rehabilitation centre) <br> <br> <hr> <br>  <br>  
劊子手 <br> kwe tsz seu <br>	<br> Executioner <br> <br> <hr> <br>  <br>  
"機器刀 <br> kyi ky'i tau <br>"	<br> Guillotine <br> <br> <hr> <br>  <br>  
萬國公法 <br> van kóh kúng fah <br>	<br> International law <br> <br> <hr> <br>  <br>  
列強 <br> lih gyáng <br>	<br> The great powers <br> <br> <hr> <br>  <br>  
承認 <br> dsung nyung <br>	<br> To recognise, as a new government <br> <br> <hr> <br>  <br>  
"利益 <br> li y'uh <br>"	<br> Priviledges, as of mining <br> <br> <hr> <br>  <br>  
均勢 <br> kyün sz <br>	<br> Equal priviledges as accorded by favoured nation clause <br> <br> <hr> <br>  <br>  
"利益均沾 <br> li y'uh kyün tsen <br>"	<br> Equal priviledges as accorded by favoured nation clause <br> <br> <hr> <br>  <br>  
外交 <br> we kyau <br>	<br> Foreign intercourse <br> <br> <hr> <br>  <br>  
外交 <br> ngá kyau <br>	<br> Foreign intercourse <br> <br> <hr> <br>  <br>  
交涉師 <br> kyau dseh sz <br>	<br> Commissioner of foreign affairs <br> <br> <hr> <br>  <br>  
"勢力圈 <br> sz lih ky'ön <br>"	<br> Sphere of influence <br> <br> <hr> <br>  <br>  
干預 <br> kön yü <br>	<br> Intervention, to intervene, to intermeddle <br> <br> <hr> <br>  <br>  
局外 <br> gyóh we <br>	<br> Neutral <br> <br> <hr> <br>  <br>  
中立<div><br><div>中曆<br></div></div> <br> tsúng lih <br>	<br> a. Neutral<div><br></div><div>b. Chinese calendar</div> <br> <br> <hr> <br>  <br>  
治外法權 <br> dsz we fah gyön <br>	<br> Extraterritoriality <br> <br> <hr> <br>  <br>  
歸化 <br> kwe hwó <br>	<br> Naturalisation (becoming Chinese citizens) <br> <br> <hr> <br>  <br>  
"立約 <br> lih y'áh <br>"	<br> To make a treaty <br> <br> <hr> <br>  <br>  
外交團 <br> ngá kyau dön <br>	<br> Diplomatic body <br> <br> <hr> <br>  <br>  
公使<div><br></div><div>公司<br></div> <br> kúng sz <br>	<br> a. Ambassador, foreign minister<div><br></div><div>b. A company for transacting business of any kind</div> <br> <br> <hr> <br>  <br>  
"欽差 <br> ky'ung ts'á <br>"	<br> Ambassador, foreign minister <br> <br> <hr> <br>  <br>  
外交大使 <br> we kyau dá sz <br>	<br> Ambassador, foreign minister <br> <br> <hr> <br>  <br>  
全權 <br> dsin gyön <br>	<br> Plenipotentiary (diplomat with full powers) <br> <br> <hr> <br>  <br>  
領事官 <br> ling zz kwen <br>	<br> Consul <br> <br> <hr> <br>  <br>  
專使 <br> tsen sz <br>	<br> Envoy extraordinary <br> <br> <hr> <br>  <br>  
"賠款 <br> be kw'en <br>"	<br> Indemnity <br> <br> <hr> <br>  <br>  
借外債 <br> tsiá ngá tsá <br>	<br> To negotiate a foreign loan <br> <br> <hr> <br>  <br>  
僑民 <br> gyau ming <br>	<br> Emigrants <br> <br> <hr> <br>  <br>  
"海橋 <br> h'e gyau <br>"	<br> Emigrants from beyond the sea <br> <br> <hr> <br>  <br>  
華僑 <br> wó gyau <br>	<br> Chinese emigrants <br> <br> <hr> <br>  <br>  
萬國弭兵會 <br> van kóh mi ping we <br>	<br> The Hague conference <br> <br> <hr> <br>  <br>  
"海外和平會 <br> h'e ngá hú bing we <br>"	<br> The Hague conference <br> <br> <hr> <br>  <br>  
殖民地 <br> dsuh ming di <br>	<br> Settlement of colonists <br> <br> <hr> <br>  <br>  
中外互巿 <br> tsúng ngá hú zz <br>	<br> International trade <br> <br> <hr> <br>  <br>  
"海禁大開 <br> h'e kyung dá k'e <br>"	<br> Open to trade <br> <br> <hr> <br>  <br>  
閉關自守 <br> pi kwan zz seu <br>	<br> Closed to trade <br> <br> <hr> <br>  <br>  
租界 <br> tsú ká <br>	<br> Foreign concessions <br> <br> <hr> <br>  <br>  
四國銀行團 <br> sz kóh nyung hong dön <br>	<br> The four power syndicate <br> <br> <hr> <br>  <br>  
外債 <br> ngá tsá <br>	<br> Foreign loans <br> <br> <hr> <br>  <br>  
外債 <br> we tsá <br>	<br> Foreign loans <br> <br> <hr> <br>  <br>  
勢力範圍 <br> sz lih van we <br>	<br> Sphere of influence <br> <br> <hr> <br>  <br>  
商務 <br> song vú <br>	<br> Trade or commerce <br> <br> <hr> <br>  <br>  
經濟界 <br> kyung tsi kyá <br>	<br> Financiers <br> <br> <hr> <br>  <br>  
商會 <br> song we <br>	<br> Board of trade, chamber of commerce <br> <br> <hr> <br>  <br>  
商務總會 <br> song vú tsúng we <br>	<br> Board of trade, chamber of commerce <br> <br> <hr> <br>  <br>  
商務公所 <br> song vú kúng sú <br>	<br> Chamber of commerce (building) <br> <br> <hr> <br>  <br>  
業公會 <br> nyih kúng we <br>	<br> Trade union, a guild used after name of trade <br> <br> <hr> <br>  <br>  
實業團 <br> zeh nyih dön <br>	<br> Trade union,a&nbsp; guild, used after name of trade <br> <br> <hr> <br>  <br>  
有限公司 <br> yeu han kúng sz <br>	<br> A limited company <br> <br> <hr> <br>  <br>  
事務所 <br> zz vú sú <br>	<br> An office <br> <br> <hr> <br>  <br>  
股東 <br> kú túng <br>	<br> Capitalist, shareholder <br> <br> <hr> <br>  <br>  
資本家 <br> tsz pung kyá <br>	<br> Capitalist <br> <br> <hr> <br>  <br>  
勞動家 <br> lau dúng kyá <br>	<br> Labourer <br> <br> <hr> <br>  <br>  
製造局 <br> tsz zau gyóh <br>	<br> Manufactory, factory, workshop <br> <br> <hr> <br>  <br>  
"工藝廠 <br> kúng nyi ts'áng <br>"	<br> Manufactory, factory, workshop <br> <br> <hr> <br>  <br>  
作坊 <br> tsoh vong <br>	<br> Manufactory, factory, workshop <br> <br> <hr> <br>  <br>  
銷路 <br> siau lú <br>	<br> Market for goods, consumption <br> <br> <hr> <br>  <br>  
原料 <br> nyön liau <br>	<br> Raw materials <br> <br> <hr> <br>  <br>  
商標 <br> song piau <br>	<br> Trademark <br> <br> <hr> <br>  <br>  
專利 <br> tsen li <br>	<br> A patent <br> <br> <hr> <br>  <br>  
權利 <br> gyön li <br>	<br> 1. A patent<div>2. Privilege, rights</div> <br> <br> <hr> <br>  <br>  
特賣 <br> duh má <br>	<br> A patent <br> <br> <hr> <br>  <br>  
獨佔事業 <br> dóh tsen zz nyih <br>	<br> Monopoly <br> <br> <hr> <br>  <br>  
商戰 <br> song tsen <br>	<br> Commercial upheavel, competition in trade <br> <br> <hr> <br>  <br>  
罷工 <br> bá kúng <br>	<br> Strike, to go on strike <br> <br> <hr> <br>  <br>  
齊行罷工 <br> dsi hong bá kúng <br>	<br> Strike, to go on strike, entire establishment off on a strike <br> <br> <hr> <br>  <br>  
抵制 <br> ti tsz <br>	<br> Boycott <br> <br> <hr> <br>  <br>  
"經濟困難 <br> kyung tsi kw'ung nan <br>"	<br> Stringency of money matter ~money is tight <br> <br> <hr> <br>  <br>  
"底款 <br> ti kw'en <br>"	<br> Unexpended balance <br> <br> <hr> <br>  <br>  
生利 <br> sung li <br>	<br> Profit, to make profit, to draw interest <br> <br> <hr> <br>  <br>  
生利 <br> sáng li <br>	<br> Profit, to make proft, to draw interest <br> <br> <hr> <br>  <br>  
分利 <br> fung li <br>	<br> To share profits <br> <br> <hr> <br>  <br>  
"抽分 <br> ts'eu fung <br>"	<br> To take a percentage <br> <br> <hr> <br>  <br>  
"買空賣空 <br> má k'úng má k'úng <br>"	<br> To speculate&nbsp;financially, speculation <br> <br> <hr> <br>  <br>  
"躉貨 <br> tung h'ú <br>"	<br> To speculate by buying in stores, and holding till price rises, to corner the market <br> <br> <hr> <br>  <br>  
合股經商 <br> keh kú kyung song <br>	<br> Stock company <br> <br> <hr> <br>  <br>  
股份 <br> kú vung <br>	<br> Stock <br> <br> <hr> <br>  <br>  
股友 <br> kú yeu <br>	<br> Shareholder <br> <br> <hr> <br>  <br>  
"客股 <br> k'áh kú <br>"	<br> Subscribed capital for stock concern <br> <br> <hr> <br>  <br>  
基本金 <br> kyi pung kyung <br>	<br> Subscribed capital for business, endowment of a college <br> <br> <hr> <br>  <br>  
股利 <br> kú li <br>	<br> Dividend <br> <br> <hr> <br>  <br>  
抵押 <br> ti ah <br>	<br> To mortgage <br> <br> <hr> <br>  <br>  
抵典 <br> ti tin <br>	<br> To mortgage <br> <br> <hr> <br>  <br>  
底質 <br> ti tseh <br>	<br> To mortgage <br> <br> <hr> <br>  <br>  
保險 <br> pau hyin <br>	<br> Insurance, to insure <br> <br> <hr> <br>  <br>  
銀行 <br> nyung hong <br>	<br> Bank <br> <br> <hr> <br>  <br>  
錢莊 <br> dsin tsong <br>	<br> Exchange bank <br> <br> <hr> <br>  <br>  
"扣餉 <br> k'eu hyáng <br>"	<br> Discount <br> <br> <hr> <br>  <br>  
"扣色 <br> k'eu suh <br>"	<br> Discount <br> <br> <hr> <br>  <br>  
"起色 <br> ky'i suh <br>"	<br> To rise in value <br> <br> <hr> <br>  <br>  
毛色 <br> mau suh <br>	<br> Depreciation of silver <br> <br> <hr> <br>  <br>  
收條 <br> seu diau <br>	<br> Receipt <br> <br> <hr> <br>  <br>  
"借債子抵押品 <br> tsiá tsá tsz ti ah p'ing <br>"	<br> Security for loan <br> <br> <hr> <br>  <br>  
資本團 <br> tsz pung dön <br>	<br> Syndicate (financial) <br> <br> <hr> <br>  <br>  
債團 <br> tsá dön <br>	<br> Syndicate for loan (financial) <br> <br> <hr> <br>  <br>  
醫道 <br> i dau <br>	<br> Medicine - the practice or profession <br> <br> <hr> <br>  <br>  
有礙衛生 <br> yeu nge we sung <br>	<br> Unsanitary <br> <br> <hr> <br>  <br>  
禾少生 (radicals) <br> miau <br>	<br> A microbe, bacteria (scientific name) <br> <br> <hr> <br>  <br>  
微蟲 <br> vi dsúng <br>	<br> Microbe, bacteria <br> <br> <hr> <br>  <br>  
微生物 <br> vi sung veh <br>	<br> A microbe, bacteria <br> <br> <hr> <br>  <br>  
傳染病 <br> dsen zen bing <br>	<br> Infectious disease <br> <br> <hr> <br>  <br>  
消毒藥 <br> siau dóh yáh <br>	<br> Disinfectant <br> <br> <hr> <br>  <br>  
防腐劑 <br> bong vú tsi <br>	<br> Antiseptic <br> <br> <hr> <br>  <br>  
牛痘 <br> nyeu deu <br>	<br> Vaccine virus (bovine) <br> <br> <hr> <br>  <br>  
鼠疫 <br> sû yóh <br>	<br> The plague of rats <br> <br> <hr> <br>  <br>  
老鼠疫 <br> lau sû yóh <br>	<br> The plague of rats <br> <br> <hr> <br>  <br>  
核子病 <br> heh tsz bing <br>	<br> The bubonic plague <br> <br> <hr> <br>  <br>  
核子病 <br> weh tsz bing <br>	<br> The bubonic plague <br> <br> <hr> <br>  <br>  
核疫 <br> heh yóh <br>	<br> The bubonic plague <br> <br> <hr> <br>  <br>  
肺疫 <br> fi yóh <br>	<br> The pneumonic plague <br> <br> <hr> <br>  <br>  
精神病 <br> tsing zung bing <br>	<br> Mental disorder <br> <br> <hr> <br>  <br>  
時災 <br> zz tse <br>	<br> Epidemic or calamity <br> <br> <hr> <br>  <br>  
"外科醫生 <br> ngá k'ú i sung <br>"	<br> Surgeon <br> <br> <hr> <br>  <br>  
"看護婦 <br> k'ön hú vú <br>"	<br> Hospital matron, a nurse <br> <br> <hr> <br>  <br>  
"剖驗 <br> p'eu nyin <br>"	<br> Autopsy <br> <br> <hr> <br>  <br>  
"剖解 <br> p'eu kyá <br>"	<br> To dissect <br> <br> <hr> <br>  <br>  
改革 <br> ke kuh <br>	<br> Reform <br> <br> <hr> <br>  <br>  
新國民 <br> sing kóh ming <br>	<br> Citizens of the new Republic <br> <br> <hr> <br>  <br>  
民權 <br> ming gyön <br>	<br> The rights of the people <br> <br> <hr> <br>  <br>  
言論自由 <br> yin lung zz yeu <br>	<br> Freedom of speech <br> <br> <hr> <br>  <br>  
"出版自由 <br> ts'eh pan zz yeu <br>"	<br> Freedom of the press <br> <br> <hr> <br>  <br>  
信仰自由 <br> sing nyáng zz yeu <br>	<br> Freedom of religious belief <br> <br> <hr> <br>  <br>  
宗教自由 <br> tsúng kyau zz yeu <br>	<br> Freedom of religious belief <br> <br> <hr> <br>  <br>  
集會自由 <br> dsih we zz yeu <br>	<br> Right to hold public meetings or convene societies <br> <br> <hr> <br>  <br>  
結社自由 <br> kyih ze zz yeu <br>	<br> Right to hold public meetings or convene societies <br> <br> <hr> <br>  <br>  
結婚自由 <br> kyih hwung zz yeu <br>	"<br> Freedom to make one's own betrothal (marriage) <br> <br> <hr> <br>  <br>  "
男女平權 <br> nen nyü bing gyön <br>	<br> Equal rights of sexes <br> <br> <hr> <br>  <br>  
"投票子權 <br> deu p'iau tsz gyön <br>"	<br> The right to vote <br> <br> <hr> <br>  <br>  
自治 <br> zz dsz <br>	<br> Self government <br> <br> <hr> <br>  <br>  
選舉 <br> sin kyü <br>	<br> To vote <br> <br> <hr> <br>  <br>  
"投票 <br> deu p'iau <br>"	<br> Ballot, to cast a vote <br> <br> <hr> <br>  <br>  
"投票櫃 <br> deu p'iau gyü <br>"	<br> Ballot box <br> <br> <hr> <br>  <br>  
大衆公論 <br> dá tsúng kúng lung <br>	<br> Public sentiment <br> <br> <hr> <br>  <br>  
社會公論 <br> ze we kúng lung <br>	<br> Public sentiment <br> <br> <hr> <br>  <br>  
"民氣 <br> ming ky'i <br>"	<br> Public sentiment <br> <br> <hr> <br>  <br>  
精神 <br> tsing zung <br>	<br> 1. Spirit<div>2. Republican spirit</div> <br> <br> <hr> <br>  <br>  
"公益 <br> kúng y'uh <br>"	<br> Public good <br> <br> <hr> <br>  <br>  
公德 <br> kúng tuh <br>	<br> Regard for public good, public virtues <br> <br> <hr> <br>  <br>  
治安 <br> dsz ön <br>	<br> Public peace <br> <br> <hr> <br>  <br>  
同胞 <br> dúng pau <br>	<br> Fellow countrymen (sons of one mother) <br> <br> <hr> <br>  <br>  
獨立 <br> dóh lih <br>	<br> Independent <br> <br> <hr> <br>  <br>  
自立 <br> zz lih <br>	<br> Independent <br> <br> <hr> <br>  <br>  
主家 <br> tsû kyá <br>	<br> Free men <br> <br> <hr> <br>  <br>  
愛國 <br> e kóh <br>	<br> Patriotism <br> <br> <hr> <br>  <br>  
祖國 <br> tsú kóh <br>	<br> The fatherland <br> <br> <hr> <br>  <br>  
犧牲 <br> hyi sung <br>	<br> 1. Sacrificial victim<div>2. A patriot ready to give his life for his country</div><div>3. A martyr, a vicarious sacrifice</div> <br> <br> <hr> <br>  <br>  
敢死隊 <br> ken sz de <br>	<br> The Dare to Die society <br> <br> <hr> <br>  <br>  
決死隊 <br> kyöh sz de <br>	"<br> The Determined to Die society (ready for desperate ventures, in which one usually loses one's life, as by throwing bombs) <br> <br> <hr> <br>  <br>  "
"鐵血會 <br> t'ih hyöh we <br>"	"<br> The Blood and Iron society (ready for desperate ventures in which one usually loses one's life, as by throwing bombs) <br> <br> <hr> <br>  <br>  "
剪髮 <br> tsin fah <br>	<br> To cut the hair, to cut off the queue <br> <br> <hr> <br>  <br>  
易服 <br> yuh vóh <br>	<br> To change the national costume <br> <br> <hr> <br>  <br>  
洋裝 <br> yáng tsong <br>	<br> Foreign dress <br> <br> <hr> <br>  <br>  
西曆 <br> si lih <br>	<br> Foreign calendar <br> <br> <hr> <br>  <br>  
陽曆 <br> yáng lih <br>	<br> Foreign calendar ~ solar calendar <br> <br> <hr> <br>  <br>  
"陰曆 <br> y'ung lih <br>"	<br> Chinese calendar ~ lunar calendar <br> <br> <hr> <br>  <br>  
星期 <br> sing gyi <br>	<br> The sabbath, sunday <br> <br> <hr> <br>  <br>  
來復日 <br> le vóh zeh <br>	<br> The Sabbath Sunday <br> <br> <hr> <br>  <br>  
星期一 <br> sing gyi ih <br>	<br> Monday <br> <br> <hr> <br>  <br>  
改良 <br> ke liáng <br>	<br> To reform <br> <br> <hr> <br>  <br>  
改建 <br> ke kyin <br>	<br> To reconstruct <br> <br> <hr> <br>  <br>  
整頓 <br> tsung tung <br>	<br> 1. To repair, to reconstruct, rearrange<div>2. To perfect, to amend</div> <br> <br> <hr> <br>  <br>  
更正 <br> káng tsung <br>	<br> To repair, to reconstruct, rearrange <br> <br> <hr> <br>  <br>  
光復 <br> kwong vóh <br>	<br> Restored, recovered, to return to the right way (a return of light, re-enlightenment) <br> <br> <hr> <br>  <br>  
建設 <br> kyin seh <br>	<br> To build up, to construct <br> <br> <hr> <br>  <br>  
"破壞 <br> p'ú wá <br>"	<br> To pull down, to destroy <br> <br> <hr> <br>  <br>  
進行 <br> tsing háng <br>	<br> To advance, to progress <br> <br> <hr> <br>  <br>  
"黨派 <br> tong p'á <br>"	<br> Political parties <br> <br> <hr> <br>  <br>  
政黨 <br> tsung tong <br>	<br> Political parties <br> <br> <hr> <br>  <br>  
維新 <br> vi sing <br>	<br> Reform, progressive (holding to the new) <br> <br> <hr> <br>  <br>  
維新襠 <br> vi sing tong <br>	<br> The reform party <br> <br> <hr> <br>  <br>  
守舊 <br> seu gyeu <br>	<br> Conservative <br> <br> <hr> <br>  <br>  
頑固 <br> wan kú <br>	<br> Reactionary <br> <br> <hr> <br>  <br>  
排滿 <br> bá men <br>	<br> Antidynastic (to drive out the Manchus) <br> <br> <hr> <br>  <br>  
保皇 <br> pau wong <br>	<br> Pro dynastic <br> <br> <hr> <br>  <br>  
憲政 <br> hyin tsung <br>	<br> Constitutional <br> <br> <hr> <br>  <br>  
民政 <br> ming tsung <br>	<br> Republican <br> <br> <hr> <br>  <br>  
革命 <br> kuh ming <br>	<br> Revolutionary <br> <br> <hr> <br>  <br>  
急進黨 <br> kyih tsing tong <br>	<br> Progressives <br> <br> <hr> <br>  <br>  
均富黨 <br> kyün fú tong <br>	<br> Socialists <br> <br> <hr> <br>  <br>  
社會黨 <br> ze we tong <br>	<br> Socialists <br> <br> <hr> <br>  <br>  
社會 <br> ze we <br>	<br> A society <br> <br> <hr> <br>  <br>  
社會 <br> zó we <br>	<br> A society <br> <br> <hr> <br>  <br>  
組織 <br> tsú tsuh <br>	<br> To organise, to found, to establish, to systematise <br> <br> <hr> <br>  <br>  
"創辦 <br> ts'ong ban <br>"	<br> 1. To organise, to found, to establish, to systematise<div>2. To inaugurate, to invent</div> <br> <br> <hr> <br>  <br>  
升座 <br> sung zú <br>	<br> To take the chair of a society <br> <br> <hr> <br>  <br>  
肅會 <br> sóh we <br>	<br> To call a meeting to order <br> <br> <hr> <br>  <br>  
"開會 <br> k'e we <br>"	<br> To open a meeting <br> <br> <hr> <br>  <br>  
"全體大會 <br> dsin t'i dá we <br>"	<br> All the members present <br> <br> <hr> <br>  <br>  
會正 <br> we tsung <br>	<br> President <br> <br> <hr> <br>  <br>  
副會正 <br> fú we tsung <br>	<br> Vice president <br> <br> <hr> <br>  <br>  
記史 <br> kyi sz <br>	<br> Recording secretary <br> <br> <hr> <br>  <br>  
佐史 <br> tsú sz <br>	<br> Recording secretary <br> <br> <hr> <br>  <br>  
書記 <br> sû kyi <br>	<br> Recording secretary <br> <br> <hr> <br>  <br>  
"書啓 <br> sû ky'i <br>"	<br> Corresponding secretary <br> <br> <hr> <br>  <br>  
"司庫 <br> sz k'ú <br>"	<br> Treasurer <br> <br> <hr> <br>  <br>  
會友 <br> we yeu <br>	<br> Member of a society <br> <br> <hr> <br>  <br>  
會侶 <br> we lü <br>	<br> Associate member <br> <br> <hr> <br>  <br>  
義務會員 <br> nyi vú we yön <br>	<br> Honourary member <br> <br> <hr> <br>  <br>  
"委辦 <br> w'e ban <br>"	<br> Committee (to act) <br> <br> <hr> <br>  <br>  
"委酌 <br> w'e tsáh <br>"	<br> Committee (to deliberate upon) <br> <br> <hr> <br>  <br>  
典章 <br> tin tsáng <br>	<br> Constitution of a society <br> <br> <hr> <br>  <br>  
散堂 <br> san dong <br>	<br> To close a session <br> <br> <hr> <br>  <br>  
閉會 <br> pi we <br>	<br> To close a meeting, to disband a society <br> <br> <hr> <br>  <br>  
解散 <br> ká san <br>	<br> To dissolve or dismiss a meeting; to disband <br> <br> <hr> <br>  <br>  
解散 <br> kyá san <br>	<br> To dissolve or dismiss a meeting; to disband <br> <br> <hr> <br>  <br>  
舉 <br> kyü <br>	<br> To vote, to make a motion, to move <br> <br> <hr> <br>  <br>  
舉意 <br> kyü i <br>	<br> To vote for, to make a motion, to move <br> <br> <hr> <br>  <br>  
舉端 <br> kyü tön <br>	<br> To vote for, to make a motion, to move <br> <br> <hr> <br>  <br>  
"投票選舉 <br> deu p'iau sin kyü <br>"	<br> To vote by ballot <br> <br> <hr> <br>  <br>  
舉手選舉 <br> kyü seu sin kyü <br>	<br> To vote by show of hands <br> <br> <hr> <br>  <br>  
選定 <br> sin ding <br>	<br> Elected <br> <br> <hr> <br>  <br>  
議端 <br> nyi tön <br>	<br> A motion <br> <br> <hr> <br>  <br>  
助 <br> dsú <br>	<br> To second a motion, to assist <br> <br> <hr> <br>  <br>  
舉助 <br> kyü dsú <br>	<br> To second a motion, to assist <br> <br> <hr> <br>  <br>  
贊助 <br> tsan dsú <br>	<br> To second a motion, to assist <br> <br> <hr> <br>  <br>  
贊成 <br> tsan dsung <br>	<br> 1. To second a motion, to assist<div>2. To approve, to acquiesce, to second, to further</div> <br> <br> <hr> <br>  <br>  
議端成立 <br> nyi tön dsung lih <br>	<br> The motion is passed <br> <br> <hr> <br>  <br>  
議端成 <br> nyi tön dsung <br>	<br> The motion is passed <br> <br> <hr> <br>  <br>  
公決 <br> kúng kyöh <br>	<br> Unanimously passed <br> <br> <hr> <br>  <br>  
議端作廢 <br> nyi tön tsoh fi <br>	<br> The motion is lost <br> <br> <hr> <br>  <br>  
作爲罷論 <br> tsoh we bá lung <br>	<br> The motion is lost <br> <br> <hr> <br>  <br>  
議端不成 <br> nyi tön peh dsung <br>	<br> The motion is lost <br> <br> <hr> <br>  <br>  
多數 <br> tú sú <br>	<br> The majority <br> <br> <hr> <br>  <br>  
少數 <br> sau sú <br>	<br> The minority <br> <br> <hr> <br>  <br>  
問題 <br> vung di <br>	<br> The question under discussion <br> <br> <hr> <br>  <br>  
問題 <br> mung di <br>	<br> The question under discussion <br> <br> <hr> <br>  <br>  
"取消<div><br></div><div>取銷</div> <br> ts'ü siau <br>"	<br> a. To withdraw a motion, to cancel<div><br></div><div>b. To abolish</div> <br> <br> <hr> <br>  <br>  
消除 <br> siau dsû <br>	<br> To delete, to eliminate, to remove <br> <br> <hr> <br>  <br>  
複議 <br> fóh nyi <br>	<br> To consider (a vote) <br> <br> <hr> <br>  <br>  
"赤 <br> ts'uh <br>"	<br> The Red Cross <br> <br> <hr> <br>  <br>  
紅十字會 <br> húng zeh zz we <br>	<br> The Red cross <br> <br> <hr> <br>  <br>  
惜畜會 <br> sih hyóh we <br>	<br> Society for prevention of cruelty to animals <br> <br> <hr> <br>  <br>  
"天足會 <br> t'in tsóh we <br>"	<br> The anti foot binding society <br> <br> <hr> <br>  <br>  
共濟會 <br> kúng tsi we <br>	<br> Aid society, as in time of calamity <br> <br> <hr> <br>  <br>  
救濟會 <br> kyeu tsi we <br>	<br> Aid society, as in the time of calamity <br> <br> <hr> <br>  <br>  
辯論會 <br> bin lung we <br>	<br> Debating society <br> <br> <hr> <br>  <br>  
閱報社 <br> yöh pau ze <br>	<br> Reading club (newspapers) <br> <br> <hr> <br>  <br>  
"青年會 <br> ts'ing nyin we <br>"	"<br> The young men's Christian association, YMCA <br> <br> <hr> <br>  <br>  "
勉勵會 <br> min li we <br>	<br> Christian endeavour society <br> <br> <hr> <br>  <br>  
"義勇佈道團 <br> nyi y'úng pú dau dön <br>"	<br> Student volunteers (for ministry) <br> <br> <hr> <br>  <br>  
童子軍 <br> dúng tsz kyün <br>	<br> Boy scouts <br> <br> <hr> <br>  <br>  
特別衣服 <br> duh bih i vóh <br>	<br> Uniform, the habit of an order <br> <br> <hr> <br>  <br>  
臨時會 <br> ling zz we <br>	<br> Special meeting, extra session <br> <br> <hr> <br>  <br>  
議和會 <br> nyi hú we <br>	<br> Peace conference <br> <br> <hr> <br>  <br>  
平和會 <br> bing hú we <br>	<br> Peace conference <br> <br> <hr> <br>  <br>  
祕密會 <br> pi mih we <br>	<br> Secret societies <br> <br> <hr> <br>  <br>  
大刀會 <br> dá tau we <br>	<br> Boxers (great knife society) <br> <br> <hr> <br>  <br>  
義和拳 <br> nyi hú gyön <br>	<br> Boxers (righteous harmony fists) <br> <br> <hr> <br>  <br>  
紅燈灶 <br> húng tung tsau <br>	"<br> Red lantern society (Girls' boxer society) <br> <br> <hr> <br>  <br>  "
女革命軍 <br> nyü kuh ming kyün <br>	<br> Chinese amazons <br> <br> <hr> <br>  <br>  
"女子參政會 <br> nyü tsz ts'en tsung we <br>"	<br> Suffragettes, woman suffrage party <br> <br> <hr> <br>  <br>  
社學會 <br> ze yáh we <br>	<br> Social science, sociology <br> <br> <hr> <br>  <br>  
倫理 <br> lung li <br>	<br> Sociology, ethics <br> <br> <hr> <br>  <br>  
"社會政策 <br> ze we tsung ts'áh <br>"	<br> Sociology <br> <br> <hr> <br>  <br>  
文明 <br> vung ming <br>	<br> Civilised, enlightened <br> <br> <hr> <br>  <br>  
"半開化國 <br> pen k'e hwó kóh <br>"	<br> Semi civilised <br> <br> <hr> <br>  <br>  
野蠻 <br> yá man <br>	<br> Uncultivated, barbarous, unenlightened, uncivilised <br> <br> <hr> <br>  <br>  
進化 <br> tsing hwó <br>	<br> Progress of civilisation, advance, evolution <br> <br> <hr> <br>  <br>  
"退化 <br> t'e hwó <br>"	<br> Decadence or decline of civilisation <br> <br> <hr> <br>  <br>  
黃種 <br> wong tsúng <br>	<br> The Mongolian race <br> <br> <hr> <br>  <br>  
白種 <br> báh tsúng <br>	<br> The Caucasian race <br> <br> <hr> <br>  <br>  
上流社會 <br> zong lieu ze we <br>	<br> The upper classes <br> <br> <hr> <br>  <br>  
下流社會 <br> yá lieu ze we <br>	<br> The lower classes, the submerged tenth <br> <br> <hr> <br>  <br>  
農界 <br> núng kyá <br>	<br> Farmers <br> <br> <hr> <br>  <br>  
工界 <br> kúng kyá <br>	<br> Labourers, workmen <br> <br> <hr> <br>  <br>  
商界 <br> song kyá <br>	<br> Merchants <br> <br> <hr> <br>  <br>  
學界 <br> yáh kyá <br>	<br> The educational circles, including both teachers and pupils <br> <br> <hr> <br>  <br>  
女界 <br> nyü kyá <br>	<br> The female sex, woman <br> <br> <hr> <br>  <br>  
女權 <br> nyü gyön <br>	"<br> Women's rights <br> <br> <hr> <br>  <br>  "
均富 <br> kyün fú <br>	<br> Socialism <br> <br> <hr> <br>  <br>  
社會主義 <br> ze we tsû nyi <br>	<br> Socialism <br> <br> <hr> <br>  <br>  
人滿爲患 <br> zung men we wan <br>	<br> Overpopulation <br> <br> <hr> <br>  <br>  
謀生 <br> meu sung <br>	<br> To devise means of livelihood <br> <br> <hr> <br>  <br>  
"移民墾荒 <br> yi ming k'ung hwong <br>"	<br> Settling waste lands, colonisation <br> <br> <hr> <br>  <br>  
歐化 <br> eu hwó <br>	<br> To europeanise, to westernise <br> <br> <hr> <br>  <br>  
歐羅巴 <br> eu lú pó <br>	<br> Europe <br> <br> <hr> <br>  <br>  
歐風 <br> eu fúng <br>	<br> European customs <br> <br> <hr> <br>  <br>  
舞臺 <br> vú de <br>	<br> Public stage (dancing platform) <br> <br> <hr> <br>  <br>  
大舞臺 <br> dá vú de <br>	"<br> All the world's stage <br> <br> <hr> <br>  <br>  "
演說 <br> in söh <br>	<br> To lecture, a lecture, an address <br> <br> <hr> <br>  <br>  
"音樂會 <br> y'ung yáh we <br>"	<br> Concert <br> <br> <hr> <br>  <br>  
樂隊 <br> yáh de <br>	<br> band of musicians, an orchestra <br> <br> <hr> <br>  <br>  
洋號 <br> yáng hau <br>	<br> Cornet <br> <br> <hr> <br>  <br>  
風琴 <br> fúng gyung <br>	<br> Organ <br> <br> <hr> <br>  <br>  
鋼琴 <br> kong gyung <br>	<br> Piano <br> <br> <hr> <br>  <br>  
"美學 <br> m'e yáh <br>"	<br> The fine arts <br> <br> <hr> <br>  <br>  
"美術 <br> m'e dseh <br>"	<br> The fine arts <br> <br> <hr> <br>  <br>  
閱報所 <br> yöh pau sú <br>	<br> A public reading room <br> <br> <hr> <br>  <br>  
藏書室 <br> dsong sû suh <br>	<br> Library <br> <br> <hr> <br>  <br>  
博覽會 <br> póh lan we <br>	<br> Exposition (exhibition of art or trade goods) <br> <br> <hr> <br>  <br>  
賽珍會 <br> se tsung we <br>	<br> Exposition (exhibition of art or trade goods) <br> <br> <hr> <br>  <br>  
"勸業會 <br> ky'ön nyih we <br>"	<br> Industrial exposition (exhibition) <br> <br> <hr> <br>  <br>  
紀念碑 <br> kyi nyan pe <br>	<br> Commemorative monument <br> <br> <hr> <br>  <br>  
植物園 <br> dsuh veh yön <br>	<br> Botanical gardens <br> <br> <hr> <br>  <br>  
動物園 <br> dúng veh yön <br>	<br> Zoological gardens <br> <br> <hr> <br>  <br>  
公園 <br> kúng yön <br>	<br> Public park <br> <br> <hr> <br>  <br>  
博物館 <br> póh veh kwen <br>	<br> Museum <br> <br> <hr> <br>  <br>  
博物園 <br> póh veh yön <br>	<br> Museum <br> <br> <hr> <br>  <br>  
"踢球 <br> t'ih gyeu <br>"	<br> Football <br> <br> <hr> <br>  <br>  
茶話會 <br> dsó wó we <br>	<br> Tea party, social gathering <br> <br> <hr> <br>  <br>  
馬戲 <br> mó hyi <br>	<br> Circus <br> <br> <hr> <br>  <br>  
儲声機 <br> dsû sung kyi <br>	<br> Phonograph <br> <br> <hr> <br>  <br>  
洋戲 <br> yáng hyi <br>	<br> Phonograph <br> <br> <hr> <br>  <br>  
話匣 <br> wó hah <br>	<br> Phonograph <br> <br> <hr> <br>  <br>  
畱声機 <br> lieu sung kyi <br>	<br> Phonograph <br> <br> <hr> <br>  <br>  
"八音盒 <br> pah y'ung hah <br>"	<br> Phonograph <br> <br> <hr> <br>  <br>  
"射影燈 <br> ze y'ung tung <br>"	<br> Magic lantern <br> <br> <hr> <br>  <br>  
"影戲 <br> y'ung hyi <br>"	<br> Magic lantern <br> <br> <hr> <br>  <br>  
活動戲 <br> weh dúng hyi <br>	<br> Cinematograph <br> <br> <hr> <br>  <br>  
然根光 <br> zen kung kwong <br>	<br> Rontgen rays, X ray machine <br> <br> <hr> <br>  <br>  
"透物光 <br> t'eu veh kwong <br>"	<br> Rontgen rays, X ray machine <br> <br> <hr> <br>  <br>  
"天文臺 <br> t'in vung de <br>"	<br> Observatory <br> <br> <hr> <br>  <br>  
觀星臺 <br> kwen sing de <br>	<br> Observatory <br> <br> <hr> <br>  <br>  
"千里鏡 <br> ts'in li kyung <br>"	<br> 1. Binoculars<div>2. Telescope</div> <br> <br> <hr> <br>  <br>  
望遠鏡 <br> vong yön kyung <br>	<br> Telescope <br> <br> <hr> <br>  <br>  
遠鏡 <br> yön kyung <br>	<br> Telescope <br> <br> <hr> <br>  <br>  
顯微鏡 <br> hyin vi kyung <br>	<br> Microscope <br> <br> <hr> <br>  <br>  
磁條 <br> dsz diau <br>	<br> Magnet <br> <br> <hr> <br>  <br>  
指南針 <br> tsz nen tsung <br>	<br> Compass <br> <br> <hr> <br>  <br>  
萬花筒 <br> van hwó dúng <br>	<br> Kaleidoscope <br> <br> <hr> <br>  <br>  
"拍照鏡 <br> p'áh tsau kyung <br>"	<br> Camera, kodak <br> <br> <hr> <br>  <br>  
"拍照 <br> p'áh tsau <br>"	<br> To photograph <br> <br> <hr> <br>  <br>  
"撮影 <br> ts'öh y'ung <br>"	<br> To take portraits with camera, to photograph <br> <br> <hr> <br>  <br>  
寫真 <br> siá tsung <br>	<br> To take portraits by hand (as painting, drawing, photography, etc) <br> <br> <hr> <br>  <br>  
輪船 <br> lung zen <br>	<br> Steamer, steamboat <br> <br> <hr> <br>  <br>  
"花車頭 <br> hwó ts'ó deu <br>"	<br> Locomotive engine <br> <br> <hr> <br>  <br>  
"車站 <br> ts'ó dsan <br>"	<br> Railway station <br> <br> <hr> <br>  <br>  
"車票 <br> ts'ó p'iau <br>"	<br> Railway ticket <br> <br> <hr> <br>  <br>  
"游院票 <br> yeu yön p'iau <br>"	<br> Platform ticket <br> <br> <hr> <br>  <br>  
"遊玩月臺客票 <br> yeu w'an yöh de k'áh p'iau <br>"	<br> Platform ticket <br> <br> <hr> <br>  <br>  
"火車費 <br> h'ú ts'ó fi <br>"	<br> Fare (railway journey) <br> <br> <hr> <br>  <br>  
"火車价 <br> h'ú ts'ó kyá <br>"	<br> Fare (railway journey) <br> <br> <hr> <br>  <br>  
"火車价 <br> h'ú ts'ó ká <br>"	<br> Fare (railway journey) <br> <br> <hr> <br>  <br>  
"客車 <br> k'áh ts'ó <br>"	<br> Passenger train <br> <br> <hr> <br>  <br>  
"貨車 <br> h'ú ts'ó <br>"	<br> Freight train <br> <br> <hr> <br>  <br>  
"專車 <br> tsen ts'ó <br>"	<br> Special train <br> <br> <hr> <br>  <br>  
地道 <br> di dau <br>	<br> Subway <br> <br> <hr> <br>  <br>  
"手搖車 <br> seu yau ts'ó <br>"	<br> Hand car (pump trolley) <br> <br> <hr> <br>  <br>  
"電車 <br> din ts'ó <br>"	<br> Electric tram, a trolley <br> <br> <hr> <br>  <br>  
"單軌鐵路 <br> tan kwe t'ih lú <br>"	<br> Monorail <br> <br> <hr> <br>  <br>  
"踋踏車 <br> kyáh dah ts'ó <br>"	<br> Bicycle <br> <br> <hr> <br>  <br>  
"自行車 <br> zz hong ts'ó <br>"	<br> Bicycle <br> <br> <hr> <br>  <br>  
"四輪車 <br> sz lung ts'ó <br>"	<br> Open carriage <br> <br> <hr> <br>  <br>  
"馬車 <br> mó ts'ó <br>"	<br> Foreign carriage <br> <br> <hr> <br>  <br>  
"黃包車 <br> wong pau ts'ó <br>"	<br> Rubber tired rickshaw <br> <br> <hr> <br>  <br>  
執照 <br> tseh tsau <br>	<br> License (for public carriage), a passport <br> <br> <hr> <br>  <br>  
"火油機 <br> h'ú yeu kyi <br>"	<br> Oil engine <br> <br> <hr> <br>  <br>  
"氣車 <br> ky'i ts'ó <br>"	<br> Automobile <br> <br> <hr> <br>  <br>  
"飛行器 <br> fi yung ky'i <br>"	<br> Flying machine <br> <br> <hr> <br>  <br>  
"飛器 <br> fi ky'i <br>"	<br> Flying machine <br> <br> <hr> <br>  <br>  
"飛艇 <br> fi t'ing <br>"	<br> Flying machine <br> <br> <hr> <br>  <br>  
"飛行車 <br> fi yung ts'ó <br>"	<br> Flying machine <br> <br> <hr> <br>  <br>  
"電音 <br> din y'ung <br>"	<br> Telegram <br> <br> <hr> <br>  <br>  
電報 <br> din pau <br>	<br> Telegram <br> <br> <hr> <br>  <br>  
電碼 <br> din mó <br>	<br> Telegraphic code <br> <br> <hr> <br>  <br>  
無線電報 <br> vú sin din pau <br>	<br> Wireless telegraphy <br> <br> <hr> <br>  <br>  
電纜 <br> din lan <br>	<br> Submarine telegraph cable <br> <br> <hr> <br>  <br>  
風輪 <br> fúng lung <br>	<br> Windmill <br> <br> <hr> <br>  <br>  
"鐵管 <br> t'ih kwen <br>"	<br> Iron pipes (as for water or gas) <br> <br> <hr> <br>  <br>  
自來水 <br> zz le sz <br>	<br> Waterworks water <br> <br> <hr> <br>  <br>  
自鳴鐘 <br> zz ming tsúng <br>	<br> Striking clock <br> <br> <hr> <br>  <br>  
鬧鐘 <br> nau tsúng <br>	<br> Alarm clock <br> <br> <hr> <br>  <br>  
酒燈 <br> tsieu tung <br>	<br> Spirit lamp (alcohol) <br> <br> <hr> <br>  <br>  
路燈 <br> lú tung <br>	<br> Street lamp <br> <br> <hr> <br>  <br>  
"自來火 <br> zz le h'ú <br>"	<br> Illuminating gas <br> <br> <hr> <br>  <br>  
"煤氣 <br> me ky'i <br>"	<br> Illuminating gas <br> <br> <hr> <br>  <br>  
"煤氣燈 <br> me ky'i tung <br>"	<br> Gas burners or jets <br> <br> <hr> <br>  <br>  
電燈 <br> din tung <br>	<br> Electric light <br> <br> <hr> <br>  <br>  
電弧燈 <br> din hú tung <br>	<br> Electric arc light <br> <br> <hr> <br>  <br>  
電熒燈 <br> din yúng tung <br>	<br> Incandescent light <br> <br> <hr> <br>  <br>  
代那模 <br> de ná mú <br>	<br> Dynamo (electric generator) <br> <br> <hr> <br>  <br>  
電鈴 <br> din ling <br>	<br> Electric bell <br> <br> <hr> <br>  <br>  
電話 <br> din wó <br>	<br> Telephone <br> <br> <hr> <br>  <br>  
德律風 <br> tuh lih fúng <br>	<br> Telephone <br> <br> <hr> <br>  <br>  
"龍鬚菜 <br> lúng sú ts'e <br>"	<br> Asaparagus <br> <br> <hr> <br>  <br>  
波羅果 <br> pú lú kú <br>	<br> Pineapple <br> <br> <hr> <br>  <br>  
覆盆子 <br> fóh bung tsz <br>	<br> Raspberry (inverted bowl, from the shape of the berry) <br> <br> <hr> <br>  <br>  
楊梅果 <br> yáng me kú <br>	<br> Strawberry <br> <br> <hr> <br>  <br>  
"初高辣 <br> ts'ú kau lah <br>"	<br> Chocolate <br> <br> <hr> <br>  <br>  
"摳摳 <br> k'eu k'eu <br>"	<br> Cocoa <br> <br> <hr> <br>  <br>  
"汽水 <br> ky'i sz <br>"	<br> Aerated water <br> <br> <hr> <br>  <br>  
奶油 <br> ná yeu <br>	<br> Butter <br> <br> <hr> <br>  <br>  
奶餅 <br> ná ping <br>	<br> Cheese <br> <br> <hr> <br>  <br>  
"褲煤 <br> k'ú me <br>"	<br> Coke <br> <br> <hr> <br>  <br>  
"海絨 <br> h'e nyúng <br>"	<br> Sponge <br> <br> <hr> <br>  <br>  
棕色 <br> tsúng suh <br>	<br> Brown (coconut colour) <br> <br> <hr> <br>  <br>  
別針 <br> bih tsung <br>	<br> Pin <br> <br> <hr> <br>  <br>  
定針 <br> ding tsung <br>	<br> Pin <br> <br> <hr> <br>  <br>  
關針 <br> kwan tsung <br>	<br> 1. Pin<div>2. Safety pin</div> <br> <br> <hr> <br>  <br>  
"扣針 <br> k'eu tsung <br>"	<br> Safety pin <br> <br> <hr> <br>  <br>  
鋼筆 <br> kong pih <br>	<br> Steel pen <br> <br> <hr> <br>  <br>  
鋼筆頭 <br> kong pih deu <br>	<br> Steel pen <br> <br> <hr> <br>  <br>  
墨水 <br> muh sz <br>	<br> Foreign ink <br> <br> <hr> <br>  <br>  
"打字機器 <br> táng zz kyi ky'i <br>"	<br> Type writer <br> <br> <hr> <br>  <br>  
送信䈬 <br> súng sing bú <br>	<br> Chit book (notebook) <br> <br> <hr> <br>  <br>  
"蒼蠅紙 <br> ts'ong y'ung tsz <br>"	<br> Fly paper <br> <br> <hr> <br>  <br>  
"鐵紗窗 <br> t'ih só ts'ong <br>"	<br> Window screens of wire gauze <br> <br> <hr> <br>  <br>  
打扇 <br> táng sen <br>	<br> Punkah (rotating fan activated by pulling rope) <br> <br> <hr> <br>  <br>  
風扇 <br> fúng sen <br>	<br> Punkah (rotating fan activated by pulling rope) <br> <br> <hr> <br>  <br>  
地蓆 <br> di dsih <br>	<br> Straw matting <br> <br> <hr> <br>  <br>  
"地窨子 <br> di y'ung tsz <br>"	<br> Cellar <br> <br> <hr> <br>  <br>  
地爐 <br> di lú <br>	<br> Hot air furnace <br> <br> <hr> <br>  <br>  
水龍 <br> sz lúng <br>	<br> Garden hose <br> <br> <hr> <br>  <br>  
肥田料 <br> vi din liau <br>	<br> Fertilisers <br> <br> <hr> <br>  <br>  
萬牲園 <br> van sung yön <br>	<br> Zoological gardens <br> <br> <hr> <br>  <br>  
香煙 <br> hyáng in <br>	<br> Cigarette <br> <br> <hr> <br>  <br>  
活字記人 <br> weh zz kyi nyung <br>	<br> Typist, typewriter (person) <br> <br> <hr> <br>  <br>  
活字機 <br> weh zz kyi <br>	<br> Typewriter machine <br> <br> <hr> <br>  <br>  
速記人 <br> sóh kyi nyung <br>	<br> Stenographer (scribe) <br> <br> <hr> <br>  <br>  
宗教 <br> tsúng kyau <br>	<br> Religion <br> <br> <hr> <br>  <br>  
"差會 <br> ts'á we <br>"	<br> Mission (Christian) <br> <br> <hr> <br>  <br>  
佈道會 <br> pú dau we <br>	<br> Missionary society <br> <br> <hr> <br>  <br>  
來復會 <br> le vóh we <br>	<br> Advent Christian mission <br> <br> <hr> <br>  <br>  
公理會 <br> kúng li we <br>	<br> American board, congregational church or mission <br> <br> <hr> <br>  <br>  
聖公會 <br> sung kúng we <br>	<br> American church mission <br> <br> <hr> <br>  <br>  
安立甘會 <br> ön lih ken we <br>	<br> Anglican mission, church of England <br> <br> <hr> <br>  <br>  
浸禮會 <br> tsing li we <br>	<br> Baptist church or mission <br> <br> <hr> <br>  <br>  
浸信傳道部 <br> tsing sing dsen dau bú <br>	<br> South baptist church or mission <br> <br> <hr> <br>  <br>  
巴色會 <br> pó suh we <br>	<br> Basle mission <br> <br> <hr> <br>  <br>  
信義堂 <br> sing nyi dong <br>	<br> Berlin missionary society <br> <br> <hr> <br>  <br>  
"英美會 <br> y'ung m'e we <br>"	<br> Canadian methodist mission <br> <br> <hr> <br>  <br>  
星期# <br> sing gyi # <br>	<br> Day of the week <br> <br> <hr> <br>  <br>  
內地會 <br> ne di we <br>	<br> China inland mission <br> <br> <hr> <br>  <br>  
宣道會 <br> sin dau we <br>	<br> Christian and missionary alliance <br> <br> <hr> <br>  <br>  
基督徒公會 <br> kyi tóh dú kúng we <br>	<br> Christian mission <br> <br> <hr> <br>  <br>  
"大英教會 <br> dá y'ung kyau we <br>"	<br> Church missionary society <br> <br> <hr> <br>  <br>  
"蘇格蘭福音堂 <br> sú kuh lan fóh y'ung dong <br>"	<br> Church of Scotland mission <br> <br> <hr> <br>  <br>  
基督教會 <br> kyi tóh kyau we <br>	<br> Foreign christian missionary society <br> <br> <hr> <br>  <br>  
循理會 <br> dsing li we <br>	<br> Free methodist mission <br> <br> <hr> <br>  <br>  
貴格會 <br> kwe kuh we <br>	"<br> Friends' mission <br> <br> <hr> <br>  <br>  "
公誼會 <br> kúng nyi we <br>	"<br> Friends' foreign mission <br> <br> <hr> <br>  <br>  "
同善會 <br> dúng zen we <br>	<br> General protestant mission of Germany <br> <br> <hr> <br>  <br>  
鴻恩會 <br> húng ung we <br>	"<br> Hauge's Synodes mission <br> <br> <hr> <br>  <br>  "
倫敦會 <br> lung tung we <br>	<br> London mission <br> <br> <hr> <br>  <br>  
路德會 <br> lú tuh we <br>	<br> Lutheran mission or church <br> <br> <hr> <br>  <br>  
"美以美會 <br> m'e i m'e we <br>"	<br> Methodist episopal church or mission <br> <br> <hr> <br>  <br>  
監理公會 <br> kan li kúng we <br>	<br> South methodist episcopal church or mission <br> <br> <hr> <br>  <br>  
信義會 <br> sing nyi we <br>	<br> 1. Norwegian missionary society<div>2. Finnish missionary society</div> <br> <br> <hr> <br>  <br>  
使徒信心會 <br> sz dú sing sing we <br>	<br> Pentecostal mission <br> <br> <hr> <br>  <br>  
長老會 <br> tsáng lau we <br>	<br> Presbyterian church or mission <br> <br> <hr> <br>  <br>  
歸正會 <br> kwe tsung we <br>	<br> Reformed church of America <br> <br> <hr> <br>  <br>  
"複初會 <br> vóh ts'ú we <br>"	<br> Reformed church of the United states <br> <br> <hr> <br>  <br>  
"約老會 <br> y'áh lau we <br>"	<br> Reformed presbyterian mission <br> <br> <hr> <br>  <br>  
禮賢會 <br> li yin we <br>	<br> Rhenish mission <br> <br> <hr> <br>  <br>  
協同會 <br> yah dúng we <br>	<br> Scandinavian alliance mission <br> <br> <hr> <br>  <br>  
安息會 <br> ön sih we <br>	<br> Seventh day baptist mission <br> <br> <hr> <br>  <br>  
"福音會 <br> fóh y'ung we <br>"	<br> South Chihli mission <br> <br> <hr> <br>  <br>  
浸信會 <br> tsing sing we <br>	<br> Swedish baptist mission <br> <br> <hr> <br>  <br>  
瑞華會 <br> dsöi wó we <br>	<br> Swedish mission <br> <br> <hr> <br>  <br>  
行道會 <br> háng dau we <br>	<br> Swedish missionary society <br> <br> <hr> <br>  <br>  
遵道會 <br> tsung dau we <br>	<br> United evangelical church <br> <br> <hr> <br>  <br>  
同行會 <br> dúng yung we <br>	<br> United brethren in christ <br> <br> <hr> <br>  <br>  
偕我公會 <br> kyá ngú kúng we <br>	<br> United methodist free church <br> <br> <hr> <br>  <br>  
循道會 <br> dsing dau we <br>	<br> Wesleyan missionary society <br> <br> <hr> <br>  <br>  
女公會 <br> nyü kúng we <br>	"<br> Woman's union missionary <br> <br> <hr> <br>  <br>  "
聖經會 <br> sung kyung we <br>	<br> American bible society <br> <br> <hr> <br>  <br>  
聖書公會 <br> sung sû kúng we <br>	<br> British and foreign bible society <br> <br> <hr> <br>  <br>  
廣學會 <br> kwong yáh we <br>	<br> Christian literature society <br> <br> <hr> <br>  <br>  
信仰 <br> sing nyáng <br>	<br> Religious belief <br> <br> <hr> <br>  <br>  
奮興會 <br> fung hyung we <br>	<br> Revival meetings <br> <br> <hr> <br>  <br>  
復興會 <br> vóh hyung we <br>	<br> Revival meetings <br> <br> <hr> <br>  <br>  
"勸化論 <br> ky'ön hwó lung <br>"	<br> Sermon <br> <br> <hr> <br>  <br>  
解經論 <br> ká kyung lung <br>	<br> Sermon <br> <br> <hr> <br>  <br>  
題目 <br> di móh <br>	<br> Text <br> <br> <hr> <br>  <br>  
祝福 <br> tsóh fóh <br>	<br> Benediction, to pronounce a benediction (to bless) <br> <br> <hr> <br>  <br>  
禱告會 <br> tau kau we <br>	<br> Prayer meeting <br> <br> <hr> <br>  <br>  
公祈 <br> kúng gyi <br>	<br> Prayer meeting <br> <br> <hr> <br>  <br>  
守晨更 <br> seu zung kung <br>	<br> To keep the morning watch (early devotions) <br> <br> <hr> <br>  <br>  
密禱 <br> mih tau <br>	<br> Private devotions (worship) <br> <br> <hr> <br>  <br>  
默禱 <br> muh tau <br>	<br> Silent prayer <br> <br> <hr> <br>  <br>  
堅信禮 <br> kyin sing li <br>	<br> Confirmation <br> <br> <hr> <br>  <br>  
浸禮 <br> tsing li <br>	<br> Immersion <br> <br> <hr> <br>  <br>  
牧師 <br> móh sz <br>	<br> Minister over christian church, pastor <br> <br> <hr> <br>  <br>  
主教 <br> tsû kyau <br>	<br> Bishop <br> <br> <hr> <br>  <br>  
監督 <br> kan tóh <br>	<br> Bishop <br> <br> <hr> <br>  <br>  
會督 <br> we tóh <br>	<br> Bishop <br> <br> <hr> <br>  <br>  
女會吏 <br> nyü we li <br>	<br> Deaconess <br> <br> <hr> <br>  <br>  
"咏詩班 <br> y'úng sz pan <br>"	<br> Choir <br> <br> <hr> <br>  <br>  
中會<div><br></div><div>總會<br></div> <br> tsúng we <br>	<br> a. Presbytery (ruling body of presbyterian church)<div><br></div><div>b. General assembly (presbyterian church) or General conference (methodist)</div> <br> <br> <hr> <br>  <br>  
大會 <br> dá we <br>	<br> Synod (council of church) <br> <br> <hr> <br>  <br>  
傳導先生 <br> dsen dau sin sáng <br>	<br> Evangelist <br> <br> <hr> <br>  <br>  
女傳導 <br> nyü dsen dau <br>	<br> Bible woman <br> <br> <hr> <br>  <br>  
長老 <br> tsáng lau <br>	<br> Elder in presbyterian church <br> <br> <hr> <br>  <br>  
神道學 <br> zung dau yáh <br>	<br> Theology <br> <br> <hr> <br>  <br>  
"寬門 <br> kw'en mung <br>"	<br> Broad or liberal (as in theology) <br> <br> <hr> <br>  <br>  
迷信 <br> mi sing <br>	<br> Superstition <br> <br> <hr> <br>  <br>  
教育 <br> kyau yóh <br>	<br> Education <br> <br> <hr> <br>  <br>  
"強迫教育 <br> gyáng p'uh kyau yóh <br>"	<br> Compulsory education <br> <br> <hr> <br>  <br>  
德育 <br> tuh yóh <br>	<br> Moral culture or training <br> <br> <hr> <br>  <br>  
智育 <br> tsz yóh <br>	<br> Intellectual culture or training <br> <br> <hr> <br>  <br>  
"體育 <br> t'i yóh <br>"	<br> Physical culture or training <br> <br> <hr> <br>  <br>  
"課程 <br> k'ú dsung <br>"	<br> Curriculum <br> <br> <hr> <br>  <br>  
"教科 <br> kyau k'ú <br>"	<br> Textbooks <br> <br> <hr> <br>  <br>  
薪金 <br> sing kyung <br>	"<br> Teacher's salary (fuel and water) <br> <br> <hr> <br>  <br>  "
薪水 <br> sing söi <br>	"<br> Teacher's salary (fuel and water) <br> <br> <hr> <br>  <br>  "
學資 <br> yáh tsz <br>	<br> Tuition fee <br> <br> <hr> <br>  <br>  
學費 <br> hoh fi <br>	<br> Tuition fee <br> <br> <hr> <br>  <br>  
一季 <br> ih kyi <br>	<br> Term at school <br> <br> <hr> <br>  <br>  
官立學堂 <br> kwen lih hoh dong <br>	<br> Government schools <br> <br> <hr> <br>  <br>  
公立學堂 <br> kúng lih hoh dong <br>	<br> Public schools <br> <br> <hr> <br>  <br>  
"幼稚園 <br> y'eu dsz yön <br>"	<br> Kindergarten <br> <br> <hr> <br>  <br>  
"初等小學堂 <br> ts'ú tung siau hoh dong <br>"	<br> Primary school <br> <br> <hr> <br>  <br>  
蒙養學堂 <br> múng yáng hoh dong <br>	<br> Primary school <br> <br> <hr> <br>  <br>  
高等小學堂 <br> kau tung siau hoh dong <br>	<br> Intermediate school <br> <br> <hr> <br>  <br>  
備館 <br> be kwen <br>	<br> Preparatory school <br> <br> <hr> <br>  <br>  
中學校 <br> tsúng yáh yau <br>	<br> High school <br> <br> <hr> <br>  <br>  
高等學校 <br> kau tung yáh yau <br>	<br> College, university <br> <br> <hr> <br>  <br>  
大書院 <br> dá sû yön <br>	<br> College, university <br> <br> <hr> <br>  <br>  
法政學校 <br> fah tsung yáh yau <br>	<br> Law school <br> <br> <hr> <br>  <br>  
醫道學校 <br> i dau yáh yau <br>	<br> Medical school <br> <br> <hr> <br>  <br>  
實業學校 <br> zeh nyih yáh yau <br>	<br> Industrial school <br> <br> <hr> <br>  <br>  
工業學校 <br> kúng nyih yáh yau <br>	<br> School of technology <br> <br> <hr> <br>  <br>  
師範學校 <br> sz van yáh yau <br>	<br> Normal school <br> <br> <hr> <br>  <br>  
寄宿舍 <br> kyi sóh se <br>	<br> Dormitories <br> <br> <hr> <br>  <br>  
"膳廳 <br> zen t'ing <br>"	<br> Refectory, dining hall <br> <br> <hr> <br>  <br>  
寄宿生 <br> kyi sóh sung <br>	<br> Boarding pupils <br> <br> <hr> <br>  <br>  
正班 <br> tsung pan <br>	<br> Regular course <br> <br> <hr> <br>  <br>  
備班 <br> be pan <br>	<br> Preparatory class <br> <br> <hr> <br>  <br>  
"專門科 <br> tsen mung k'ú <br>"	<br> Special course (advanced study in particular branches) <br> <br> <hr> <br>  <br>  
選班 <br> sin pan <br>	<br> Special course (for selected studies) <br> <br> <hr> <br>  <br>  
速成班 <br> sóh dsung pan <br>	<br> Special course (for those lacking only a few studies) <br> <br> <hr> <br>  <br>  
副班 <br> fú pan <br>	<br> Special course (for conditioned students) <br> <br> <hr> <br>  <br>  
"文科 <br> vung k'ú <br>"	<br> Arts course in college or university <br> <br> <hr> <br>  <br>  
畢業 <br> pih nyih <br>	<br> To graduate from college, to complete the course of training in any art <br> <br> <hr> <br>  <br>  
文凭 <br> vung bing <br>	<br> Diploma <br> <br> <hr> <br>  <br>  
畢業生 <br> pih nyih sung <br>	<br> Post graduate students <br> <br> <hr> <br>  <br>  
留學 <br> lieu yáh <br>	<br> To study abroad, students who go abroad to study <br> <br> <hr> <br>  <br>  
團拜 <br> dön pá <br>	<br> To salute in concert, as in saluting the head master, or the tablet of Confucious <br> <br> <hr> <br>  <br>  
運動 <br> yün dúng <br>	<br> 1. Physical exercise, athletics, gymnastics<div>2. To stir up, to induce, to set others to work</div> <br> <br> <hr> <br>  <br>  
"體操 <br> t'i ts'au <br>"	<br> Physical exercise, athletics, gymnastics <br> <br> <hr> <br>  <br>  
運動會 <br> yün dúng we <br>	<br> An athletic meet, sports <br> <br> <hr> <br>  <br>  
國文 <br> kóh vung <br>	<br> Language or literature of any country <br> <br> <hr> <br>  <br>  
數學 <br> sú yáh <br>	<br> Mathematics <br> <br> <hr> <br>  <br>  
代數 <br> de sú <br>	<br> Algebra <br> <br> <hr> <br>  <br>  
植物學 <br> dsuh veh yáh <br>	<br> Botany <br> <br> <hr> <br>  <br>  
"體學 <br> t'i yáh <br>"	<br> Physiology <br> <br> <hr> <br>  <br>  
動物學 <br> dúng veh yáh <br>	<br> Zoology <br> <br> <hr> <br>  <br>  
活物學 <br> weh veh yáh <br>	<br> Biology <br> <br> <hr> <br>  <br>  
"礦務學 <br> kw'ong vú yáh <br>"	<br> Mineralogy <br> <br> <hr> <br>  <br>  
地貭學 <br> di tseh yáh <br>	<br> Geology <br> <br> <hr> <br>  <br>  
"天然界 <br> t'in zen kyá <br>"	<br> Nature <br> <br> <hr> <br>  <br>  
精神界 <br> tsing zung kyá <br>	<br> Animate creation (spiritual world) <br> <br> <hr> <br>  <br>  
"天演進化 <br> t'in in tsing hwó <br>"	<br> Evolution, the development theory <br> <br> <hr> <br>  <br>  
"物競天擇 <br> veh gyung t'in dsuh <br>"	<br> Natural selection <br> <br> <hr> <br>  <br>  
競存 <br> gyung dsung <br>	<br> The struggle for existence <br> <br> <hr> <br>  <br>  
生活上的競爭 <br> sáng weh záng tih gyung tsung <br>	<br> The struggle for existence <br> <br> <hr> <br>  <br>  
絕種 <br> dsih tsúng <br>	<br> Extinct <br> <br> <hr> <br>  <br>  
吸力 <br> hyih lih <br>	<br> Attraction (in physics) <br> <br> <hr> <br>  <br>  
"元氣 <br> nyön ky'i <br>"	<br> 1. Ether (in astronomy)<div>2. Aura and spirit</div> <br> <br> <hr> <br>  <br>  
"微氣 <br> vi ky'i <br>"	<br> Ether (in astronomy) <br> <br> <hr> <br>  <br>  
"虛氣 <br> hyü ky'i <br>"	<br> Ether (in astronomy) <br> <br> <hr> <br>  <br>  
燭光 <br> tsóh kwong <br>	<br> Candle power <br> <br> <hr> <br>  <br>  
原貭 <br> nyön tseh <br>	<br> An atom <br> <br> <hr> <br>  <br>  
貭點 <br> tseh tin <br>	<br> An atom <br> <br> <hr> <br>  <br>  
"儀器 <br> nyi ky'i <br>"	<br> Philsophical instruments (science apparatus) <br> <br> <hr> <br>  <br>  
文法 <br> vung fah <br>	<br> Grammar <br> <br> <hr> <br>  <br>  
名詞 <br> ming dsz <br>	<br> Nouns <br> <br> <hr> <br>  <br>  
死字 <br> si zz <br>	<br> Nouns (old name) <br> <br> <hr> <br>  <br>  
形容字 <br> yung yúng zz <br>	<br> Adjective <br> <br> <hr> <br>  <br>  
代名字 <br> de ming zz <br>	<br> Pronouns <br> <br> <hr> <br>  <br>  
活字 <br> weh zz <br>	<br> Verbs <br> <br> <hr> <br>  <br>  
狀字 <br> zong zz <br>	<br> Adverbs <br> <br> <hr> <br>  <br>  
顯明字 <br> hyin ming zz <br>	<br> Prepositions <br> <br> <hr> <br>  <br>  
連合字 <br> lin heh zz <br>	<br> Conjunctions <br> <br> <hr> <br>  <br>  
"感嘆字 <br> ken t'an zz <br>"	<br> Interjections <br> <br> <hr> <br>  <br>  
"印刷 <br> y'ung seh <br>"	<br> Printing <br> <br> <hr> <br>  <br>  
"印刷所 <br> y'ung seh sú <br>"	<br> Printing office <br> <br> <hr> <br>  <br>  
發行所 <br> fah háng sú <br>	<br> Publishing house <br> <br> <hr> <br>  <br>  
"出版 <br> ts'eh pan <br>"	<br> To publish <br> <br> <hr> <br>  <br>  
發行人 <br> fah háng nyung <br>	<br> Publisher <br> <br> <hr> <br>  <br>  
"編緝人 <br> pin ts'ih nyung <br>"	<br> Managing editor <br> <br> <hr> <br>  <br>  
主筆 <br> tsû pih <br>	<br> Editor <br> <br> <hr> <br>  <br>  
筆政 <br> pih tsung <br>	<br> Editor <br> <br> <hr> <br>  <br>  
訪事人 <br> fong zz nyung <br>	<br> A reporter <br> <br> <hr> <br>  <br>  
訪事員 <br> fong zz yön <br>	<br> A reporter <br> <br> <hr> <br>  <br>  
活字板 <br> weh zz pan <br>	<br> Moveable type, printed from type <br> <br> <hr> <br>  <br>  
木板 <br> móh pan <br>	<br> Wooden printing blocks, printed from blocks <br> <br> <hr> <br>  <br>  
登報 <br> tung pau <br>	<br> To put in a paper <br> <br> <hr> <br>  <br>  
論說 <br> lung söh <br>	<br> An editorial <br> <br> <hr> <br>  <br>  
時事 <br> zz zz <br>	<br> 1. The news<div>2.&nbsp; Present affairs</div> <br> <br> <hr> <br>  <br>  
時局 <br> zz gyóh <br>	<br> 1. The news<div>2. Affairs of present importance</div> <br> <br> <hr> <br>  <br>  
近事 <br> gyung zz <br>	<br> The latest news <br> <br> <hr> <br>  <br>  
新聞 <br> sing vung <br>	<br> The latest news <br> <br> <hr> <br>  <br>  
笑林 <br> siau ling <br>	<br> The funny column, amusing anecdotes <br> <br> <hr> <br>  <br>  
無名稿 <br> vú ming kau <br>	<br> Anonymous article <br> <br> <hr> <br>  <br>  
未完 <br> vi wen <br>	<br> To be continued (at the end of the article) <br> <br> <hr> <br>  <br>  
續登 <br> zóh tung <br>	<br> Continued from last <br> <br> <hr> <br>  <br>  
告白 <br> kau báh <br>	<br> Advertisement <br> <br> <hr> <br>  <br>  
廣告 <br> kwong kau <br>	<br> Notice (advertisement) <br> <br> <hr> <br>  <br>  
目錄 <br> móh lóh <br>	<br> Index <br> <br> <hr> <br>  <br>  
定報 <br> ding pau <br>	<br> To subscribe for a paper <br> <br> <hr> <br>  <br>  
訂報 <br> ting pau <br>	<br> To subscribe for a paper <br> <br> <hr> <br>  <br>  
日報 <br> zeh pau <br>	<br> Daily paper, a journal <br> <br> <hr> <br>  <br>  
星期報 <br> sing gyi pau <br>	<br> Weekly magazine or paper <br> <br> <hr> <br>  <br>  
月報 <br> yöh pau <br>	<br> Monthly magazine or paper <br> <br> <hr> <br>  <br>  
畫報 <br> wó pau <br>	<br> Illustrated magazine <br> <br> <hr> <br>  <br>  
版權 <br> pan gyön <br>	<br> Copyright <br> <br> <hr> <br>  <br>  
哲學 <br> tseh yáh <br>	<br> Philosophy <br> <br> <hr> <br>  <br>  
思理學 <br> sz li yáh <br>	<br> Logic <br> <br> <hr> <br>  <br>  
心理學 <br> sing li yáh <br>	<br> Metaphysics, psychology <br> <br> <hr> <br>  <br>  
性學 <br> sing yáh <br>	<br> Metaphysics, psychology <br> <br> <hr> <br>  <br>  
學說 <br> yáh söh <br>	<br> Speculation, theory <br> <br> <hr> <br>  <br>  
理想 <br> li siáng <br>	<br> 1. Speculation, theory<div>2.&nbsp;Ideal, theory</div> <br> <br> <hr> <br>  <br>  
"創論 <br> ts'ong lung <br>"	<br> Speculation, theory <br> <br> <hr> <br>  <br>  
公理 <br> kúng li <br>	<br> Universal principle <br> <br> <hr> <br>  <br>  
現象 <br> yin ziáng <br>	<br> Phenomena <br> <br> <hr> <br>  <br>  
"因果 <br> y'ung kú <br>"	<br> Cause and effect <br> <br> <hr> <br>  <br>  
"原因 <br> nyön y'ung <br>"	<br> Cause <br> <br> <hr> <br>  <br>  
效果 <br> yau kú <br>	<br> Effect <br> <br> <hr> <br>  <br>  
結果 <br> kyih kú <br>	<br> Effect, finale (to bear fruit) <br> <br> <hr> <br>  <br>  
成規 <br> dsung kwe <br>	<br> Precedent (established rules) <br> <br> <hr> <br>  <br>  
成見 <br> dsung kyin <br>	<br> Prejudice <br> <br> <hr> <br>  <br>  
"要義 <br> y'au nyi <br>"	<br> Important idea, main thought <br> <br> <hr> <br>  <br>  
宗旨 <br> tsúng tsz <br>	<br> 1. The leading idea, the object<div>2. Purpose, object</div> <br> <br> <hr> <br>  <br>  
主腦 <br> tsû nau <br>	<br> The leading idea, the object <br> <br> <hr> <br>  <br>  
理由 <br> li yeu <br>	<br> Ground of right, reason <br> <br> <hr> <br>  <br>  
個人 <br> kuh nyung <br>	<br> The individual <br> <br> <hr> <br>  <br>  
人格 <br> nyung káh <br>	<br> Ability, natural qualities <br> <br> <hr> <br>  <br>  
"人品 <br> nyung p'ing <br>"	<br> Moral qualities <br> <br> <hr> <br>  <br>  
性格 <br> sing káh <br>	<br> Temperament, disposition <br> <br> <hr> <br>  <br>  
性貭 <br> sing tseh <br>	<br> Temperament, disposition <br> <br> <hr> <br>  <br>  
特性 <br> duh sing <br>	<br> Distinguishing characteristics <br> <br> <hr> <br>  <br>  
特別性貭 <br> duh bih sing tseh <br>	<br> Distinguishing characteristics <br> <br> <hr> <br>  <br>  
資格 <br> tsz káh <br>	<br> 1. Character<div>2. Qualifications</div> <br> <br> <hr> <br>  <br>  
"品格 <br> p'ing káh <br>"	<br> Character <br> <br> <hr> <br>  <br>  
"體格 <br> t'i kuh <br>"	<br> Physique <br> <br> <hr> <br>  <br>  
設想 <br> seh siáng <br>	<br> To imagine or conceive <br> <br> <hr> <br>  <br>  
想像 <br> siáng ziáng <br>	<br> Imagination <br> <br> <hr> <br>  <br>  
感情 <br> ken dsing <br>	<br> 1. The emotions<div>2. Mutual relations</div> <br> <br> <hr> <br>  <br>  
情緒 <br> dsing dsü <br>	<br> The emotions <br> <br> <hr> <br>  <br>  
競爭心 <br> gyung tsung sing <br>	<br> Ambition <br> <br> <hr> <br>  <br>  
"好勝的思想 <br> h'au sung tih sz siáng <br>"	<br> Ambition <br> <br> <hr> <br>  <br>  
熱誠 <br> nyih dsung <br>	<br> Jealous, earnest, ardent, eager <br> <br> <hr> <br>  <br>  
冒險性貭 <br> mau hyin sing tseh <br>	<br> Foolhardy disposition (rash character) <br> <br> <hr> <br>  <br>  
"探險 <br> t'en hyin <br>"	<br> Adventurous, venturesome <br> <br> <hr> <br>  <br>  
依賴性 <br> i le sing <br>	<br> Dependent nature <br> <br> <hr> <br>  <br>  
強硬 <br> gyáng ngáng <br>	<br> Determined <br> <br> <hr> <br>  <br>  
激烈 <br> kyuh lih <br>	<br> Violent <br> <br> <hr> <br>  <br>  
劇烈 <br> gyuh lih <br>	<br> Violent <br> <br> <hr> <br>  <br>  
自重 <br> zz dsúng <br>	<br> Self respect <br> <br> <hr> <br>  <br>  
愛羣 <br> e gyün <br>	<br> Altruism, love for all <br> <br> <hr> <br>  <br>  
希望 <br> hyi mong <br>	<br> Hope <br> <br> <hr> <br>  <br>  
樂觀主義 <br> loh kwen tsû nyi <br>	<br> Optimism <br> <br> <hr> <br>  <br>  
悲觀主義 <br> pe kwen tsû nyi <br>	<br> Pessimism <br> <br> <hr> <br>  <br>  
哀觀主義 <br> e kwen tsû nyi <br>	<br> Pessimism <br> <br> <hr> <br>  <br>  
旁觀 <br> bong kwen <br>	<br> To regard with with indifference, onlooker <br> <br> <hr> <br>  <br>  
袖手旁觀 <br> zieu seu bong kwen <br>	<br> To regard with indifference, onlooker (to look at from the side, with the hands crossed, each in the other sleeve, as if to prove non interference) <br> <br> <hr> <br>  <br>  
義務 <br> nyi vú <br>	<br> Voluntary service <br> <br> <hr> <br>  <br>  
价值 <br> kyá dsuh <br>	<br> Worth, now used as a noun, and applied to character <br> <br> <hr> <br>  <br>  
複雜 <br> fóh dseh <br>	<br> Miscellaneous, heterogeneous, complex <br> <br> <hr> <br>  <br>  
單純 <br> tan zung <br>	<br> Unmixed, unadulterated, simple, homogeneous <br> <br> <hr> <br>  <br>  
公立 <br> kúng lih <br>	<br> Public (as in schools, etc.) <br> <br> <hr> <br>  <br>  
私立 <br> sz lih <br>	<br> Private <br> <br> <hr> <br>  <br>  
秘密 <br> pi mih <br>	<br> Secret <br> <br> <hr> <br>  <br>  
積極 <br> tsih gyuh <br>	<br> Positive, to go forward <br> <br> <hr> <br>  <br>  
消極 <br> siau gyuh <br>	<br> Negative, to draw back <br> <br> <hr> <br>  <br>  
簡易 <br> kyin yi <br>	<br> Abridged, abbreviated, easy <br> <br> <hr> <br>  <br>  
利便 <br> li bin <br>	<br> Speedy, facile (convenient, superficial and easy) <br> <br> <hr> <br>  <br>  
圓滿 <br> yön men <br>	<br> Perfect, complete <br> <br> <hr> <br>  <br>  
"充足 <br> ts'úng tsóh <br>"	<br> Perfect, complete <br> <br> <hr> <br>  <br>  
"重要 <br> dsúng y'au <br>"	<br> Important <br> <br> <hr> <br>  <br>  
間接 <br> kyin tsih <br>	<br> Indirectly, by indirect means, by middlemen <br> <br> <hr> <br>  <br>  
直接 <br> dsuh tsih <br>	"<br> Directly, of one's own initiative <br> <br> <hr> <br>  <br>  "
信用 <br> sing yúng <br>	<br> Trust, confidence <br> <br> <hr> <br>  <br>  
費手續 <br> fi seu zóh <br>	<br> Troublesome to accomplish, labourious <br> <br> <hr> <br>  <br>  
腐敗 <br> vú bá <br>	<br> Corrupt, unsound, obsolete, effete (ineffectual) <br> <br> <hr> <br>  <br>  
怪現象 <br> kwá yin ziáng <br>	<br> Abnormal, uncouth, a bad outlook (lacking good manners) <br> <br> <hr> <br>  <br>  
惡劣 <br> oh lih <br>	<br> Bad <br> <br> <hr> <br>  <br>  
"開通 <br> k'e t'úng <br>"	<br> Progressive <br> <br> <hr> <br>  <br>  
"普通 <br> p'ú t'úng <br>"	<br> Universal, generic, general <br> <br> <hr> <br>  <br>  
專門 <br> tsen mung <br>	<br> Specialised, specific <br> <br> <hr> <br>  <br>  
特別 <br> duh bih <br>	<br> Distinctive, special <br> <br> <hr> <br>  <br>  
否定 <br> feu ding <br>	<br> Undecided, wavering, uncertain <br> <br> <hr> <br>  <br>  
分裂 <br> fung lih <br>	<br> Divided <br> <br> <hr> <br>  <br>  
"統一 <br> t'úng ih <br>"	<br> United <br> <br> <hr> <br>  <br>  
共和 <br> kúng hú <br>	<br> United <br> <br> <hr> <br>  <br>  
"團體 <br> dön t'i <br>"	<br> United <br> <br> <hr> <br>  <br>  
歸併 <br> kwe ping <br>	<br> United <br> <br> <hr> <br>  <br>  
劃一 <br> wáh ih <br>	<br> Uniform, all of one stripe <br> <br> <hr> <br>  <br>  
合羣 <br> heh gyün <br>	<br> 1. All of one mind, unanimity<div>2. To amalgamate</div> <br> <br> <hr> <br>  <br>  
團結力 <br> dön kyih lih <br>	<br> United strength <br> <br> <hr> <br>  <br>  
同志 <br> dúng tsz <br>	<br> United in aim, one purpose, harmony <br> <br> <hr> <br>  <br>  
"全體 <br> dsin t'i <br>"	<br> An integar, a unit, the entire body <br> <br> <hr> <br>  <br>  
分子 <br> vung tsz <br>	<br> Fractional part <br> <br> <hr> <br>  <br>  
一部分 <br> ih bú vung <br>	<br> Fractional part <br> <br> <hr> <br>  <br>  
雙方合意 <br> song fong heh i <br>	<br> Common agreement, concord <br> <br> <hr> <br>  <br>  
"談判 <br> dan p'en <br>"	<br> Conference, a caucus <br> <br> <hr> <br>  <br>  
秩序 <br> dseh dsü <br>	<br> Orderly arrangement <br> <br> <hr> <br>  <br>  
秩序不紊 <br> dseh dsü peh vung <br>	<br> In perfect order, systematic <br> <br> <hr> <br>  <br>  
正式 <br> tsung suh <br>	<br> In an orderly manner, regular (as opposed to irregular), final (as opposed to provisional) <br> <br> <hr> <br>  <br>  
節制 <br> tsih tsz <br>	<br> Under control or authority <br> <br> <hr> <br>  <br>  
決裂 <br> kyöh lih <br>	<br> Disagreement <br> <br> <hr> <br>  <br>  
惡感 <br> oh ken <br>	<br> Enmity (malice and ill feeling) <br> <br> <hr> <br>  <br>  
下手毒 <br> hau seu dóh <br>	<br> Acts of lawlessness <br> <br> <hr> <br>  <br>  
"刺客 <br> ts'z k'áh <br>"	<br> Assassin <br> <br> <hr> <br>  <br>  
匪徒 <br> fi dú <br>	<br> Bandits, robbers <br> <br> <hr> <br>  <br>  
"海盜 <br> h'e dau <br>"	<br> Pirates <br> <br> <hr> <br>  <br>  
"土匪 <br> t'ú fi <br>"	<br> Local rowdies <br> <br> <hr> <br>  <br>  
公敵 <br> kúng dih <br>	<br> Public enemy <br> <br> <hr> <br>  <br>  
流血 <br> lieu hyöh <br>	<br> To shed blood <br> <br> <hr> <br>  <br>  
強權 <br> gyáng gyön <br>	<br> Superior force, brute force <br> <br> <hr> <br>  <br>  
羣力 <br> gyün lih <br>	<br> The force of numbers <br> <br> <hr> <br>  <br>  
壓力 <br> ah lih <br>	<br> 1. Oppression, tyranny<div>2. Pressure</div> <br> <br> <hr> <br>  <br>  
奴隸 <br> nú di <br>	<br> Slaves (now used in a political sense - the opposite of freemen) <br> <br> <hr> <br>  <br>  
妨害 <br> fong he <br>	<br> Injury <br> <br> <hr> <br>  <br>  
失敗 <br> seh bá <br>	<br> Defeat <br> <br> <hr> <br>  <br>  
正當防衛 <br> tsung tong bong we <br>	<br> In self defence <br> <br> <hr> <br>  <br>  
暴動 <br> bau dúng <br>	<br> Insurrection, riot <br> <br> <hr> <br>  <br>  
民變 <br> ming pin <br>	<br> Insurrection <br> <br> <hr> <br>  <br>  
贓物 <br> tsong veh <br>	<br> Loot <br> <br> <hr> <br>  <br>  
手段 <br> seu dön <br>	<br> Measures <br> <br> <hr> <br>  <br>  
強硬手段 <br> gyáng ngáng seu dön <br>	<br> Drastic measures <br> <br> <hr> <br>  <br>  
"強迫手段 <br> gyáng p'uh seu dön <br>"	<br> Drastic measures <br> <br> <hr> <br>  <br>  
利害手段 <br> li he seu dön <br>	<br> Drastic measures <br> <br> <hr> <br>  <br>  
後路 <br> heu lú <br>	<br> Way of retreat <br> <br> <hr> <br>  <br>  
方面 <br> fong min <br>	<br> View point <br> <br> <hr> <br>  <br>  
眼光 <br> ngan kwong <br>	<br> Viewpoint <br> <br> <hr> <br>  <br>  
眼界 <br> ngan ká <br>	<br> View point <br> <br> <hr> <br>  <br>  
現狀 <br> yin dsong <br>	<br> Appearance, outlook, condition <br> <br> <hr> <br>  <br>  
大局 <br> dá gyóh <br>	<br> The main aspect, tout ensemble, in general, the important thing <br> <br> <hr> <br>  <br>  
形式 <br> yung suh <br>	<br> Externals (appearance) <br> <br> <hr> <br>  <br>  
表面 <br> piau min <br>	<br> The exterior, the outside, outward appearance <br> <br> <hr> <br>  <br>  
外觀 <br> we kwen <br>	<br> External appearance, the look of a thing, the exterior <br> <br> <hr> <br>  <br>  
內容 <br> ne yúng <br>	<br> The interior, the inside, containing, as follows (before a direct quotation) <br> <br> <hr> <br>  <br>  
兩方面 <br> liáng fong min <br>	<br> The two sides <br> <br> <hr> <br>  <br>  
兩造 <br> liáng zau <br>	<br> The two sides <br> <br> <hr> <br>  <br>  
雙方 <br> song fong <br>	<br> The two sides <br> <br> <hr> <br>  <br>  
動力 <br> dúng lih <br>	<br> Power (now used of political power), momentum <br> <br> <hr> <br>  <br>  
主動 <br> tsû dúng <br>	<br> Motive power, initial idea or motive (active) <br> <br> <hr> <br>  <br>  
原動 <br> nyön dúng <br>	<br> Motive power, initial idea or motive (active) <br> <br> <hr> <br>  <br>  
被動 <br> bi dúng <br>	<br> Moved, influenced (passive) <br> <br> <hr> <br>  <br>  
反動 <br> fan dúng <br>	<br> Resisting power <br> <br> <hr> <br>  <br>  
同化力 <br> dúng hwó lih <br>	<br> Influence <br> <br> <hr> <br>  <br>  
良感 <br> liáng ken <br>	<br> Good influence <br> <br> <hr> <br>  <br>  
爭執 <br> tsung tseh <br>	<br> Disagreement <br> <br> <hr> <br>  <br>  
華工 <br> wó kúng <br>	<br> Coolies in foreign countries <br> <br> <hr> <br>  <br>  
"附屬品 <br> vú zóh p'ing <br>"	<br> Accessories (as of dress) <br> <br> <hr> <br>  <br>  
"衝突 <br> ts'úng deh <br>"	<br> Mutual opposition, clashing of opinions <br> <br> <hr> <br>  <br>  
方針 <br> fong tsung <br>	<br> Direction, aim (needle of compass) <br> <br> <hr> <br>  <br>  
目的 <br> móh tih <br>	<br> Object, aim, purpose, goal <br> <br> <hr> <br>  <br>  
"基礎 <br> kyi ts'ú <br>"	<br> Foundation <br> <br> <hr> <br>  <br>  
"起點 <br> &nbsp;ky'i tin <br>"	<br> The starting point <br> <br> <hr> <br>  <br>  
地點 <br> di tin <br>	<br> A location <br> <br> <hr> <br>  <br>  
便利 <br> bin li <br>	<br> Advantage <br> <br> <hr> <br>  <br>  
"缺點 <br> ky'öh tin <br>"	<br> A defect, a shortcoming <br> <br> <hr> <br>  <br>  
極點 <br> gyuh tin <br>	<br> The climax, to the upmost <br> <br> <hr> <br>  <br>  
定點 <br> ding tin <br>	<br> The limit <br> <br> <hr> <br>  <br>  
特色 <br> duh suh <br>	<br> Peculiar excellencies, exceptional <br> <br> <hr> <br>  <br>  
特權 <br> duh gyön <br>	<br> Special priviledges or rights <br> <br> <hr> <br>  <br>  
合格 <br> heh káh <br>	<br> Requisite qualifications <br> <br> <hr> <br>  <br>  
程度 <br> dsung dú <br>	<br> Standard, grade, qualifications (level) <br> <br> <hr> <br>  <br>  
條件 <br> diau gyin <br>	<br> Items, particulars (conditions) <br> <br> <hr> <br>  <br>  
"要索 <br> y'au soh <br>"	<br> An essential, an an indispensible condition, a sine qua non, to demand <br> <br> <hr> <br>  <br>  
"養生要索 <br> yáng sung y'au soh <br>"	<br> The necessaries of life <br> <br> <hr> <br>  <br>  
生計 <br> sung kyi <br>	<br> Means of livelihood <br> <br> <hr> <br>  <br>  
"籌款 <br> dseu kw'en <br>"	<br> To secure funds <br> <br> <hr> <br>  <br>  
戶外生活 <br> hú we sáng weh <br>	<br> Outdoor employments <br> <br> <hr> <br>  <br>  
戶外生活 <br> hú ngá sáng weh <br>	<br> Outdoor employments <br> <br> <hr> <br>  <br>  
"財產 <br> dse ts'an <br>"	<br> Property <br> <br> <hr> <br>  <br>  
"不動產 <br> peh dúng ts'an <br>"	<br> Real estate <br> <br> <hr> <br>  <br>  
一份 <br> ih fung <br>	<br> A minute <br> <br> <hr> <br>  <br>  
小時 <br> siau zz <br>	<br> An hour (by foreign clock) <br> <br> <hr> <br>  <br>  
週年 <br> tseu nyin <br>	<br> Century <br> <br> <hr> <br>  <br>  
前途 <br> zin dú <br>	<br> The future (the path in front) <br> <br> <hr> <br>  <br>  
歷史 <br> lih sz <br>	<br> History <br> <br> <hr> <br>  <br>  
公僕 <br> kúng bóh <br>	<br> Public servant <br> <br> <hr> <br>  <br>  
先導 <br> sin dau <br>	<br> Forerunner <br> <br> <hr> <br>  <br>  
第三者 <br> di san tse <br>	<br> Third party (other man or woman) <br> <br> <hr> <br>  <br>  
事宜 <br> zz nyi <br>	<br> Proper business <br> <br> <hr> <br>  <br>  
幸福 <br> yung fóh <br>	<br> Happiness <br> <br> <hr> <br>  <br>  
名譽 <br> ming yü <br>	<br> Reputation, nominal <br> <br> <hr> <br>  <br>  
游宴 <br> yeu in <br>	<br> Recreation <br> <br> <hr> <br>  <br>  
"陳列品 <br> dsung lih p'ing <br>"	<br> Curio (rare unusual intriguing object) <br> <br> <hr> <br>  <br>  
追悼會 <br> tsöi dau we <br>	<br> Memorial service <br> <br> <hr> <br>  <br>  
"紀念品 <br> kyi nyan p'ing <br>"	<br> Memorial, keepsake <br> <br> <hr> <br>  <br>  
標題 <br> piau di <br>	<br> Motto <br> <br> <hr> <br>  <br>  
歡迎會 <br> hwen nyung we <br>	<br> Reception <br> <br> <hr> <br>  <br>  
"風氣 <br> fúng ky'i <br>"	<br> Customs <br> <br> <hr> <br>  <br>  
弗 <br> feh <br>	<br> The dollar sign ($) <br> <br> <hr> <br>  <br>  
遠東 <br> yön túng <br>	<br> The far east <br> <br> <hr> <br>  <br>  
東亞 <br> túng á <br>	<br> Eastern Asia <br> <br> <hr> <br>  <br>  
"提倡 <br> di ts'ong <br>"	<br> To advocate (a cause), to incite, to impel, to stimulate, to lead <br> <br> <hr> <br>  <br>  
"倡義 <br> ts'ong nyi <br>"	<br> To inaugurate (begin) <br> <br> <hr> <br>  <br>  
新發明 <br> sing fah ming <br>	<br> To invent <br> <br> <hr> <br>  <br>  
發現 <br> fah yin <br>	<br> To discover (geographical exploration) <br> <br> <hr> <br>  <br>  
主張 <br> tsû tsáng <br>	<br> To originate, to advocate <br> <br> <hr> <br>  <br>  
"發起 <br> fah ky'i <br>"	<br> To take the lead, to originate, to initiate <br> <br> <hr> <br>  <br>  
"開辦 <br> k'e ban <br>"	<br> To start a new enterprise <br> <br> <hr> <br>  <br>  
營業 <br> yung nyih <br>	<br> To plan or carry on an enterprise, to do business <br> <br> <hr> <br>  <br>  
計劃 <br> kyi wáh <br>	<br> To plan for <br> <br> <hr> <br>  <br>  
附和 <br> vú hú <br>	<br> To follow the lead of another <br> <br> <hr> <br>  <br>  
"鼓吹 <br> kú ts'öi <br>"	<br> To applaud, to endorse, to eulogise, to give public approval (to drum and pipe) <br> <br> <hr> <br>  <br>  
公認 <br> kúng zung <br>	<br> To approve unanimously <br> <br> <hr> <br>  <br>  
公認 <br> kúng nyung <br>	<br> To approve unanimously <br> <br> <hr> <br>  <br>  
維持 <br> vi dsz <br>	<br> To uphold <br> <br> <hr> <br>  <br>  
"認可 <br> zung k'au <br>"	<br> To authorise <br> <br> <hr> <br>  <br>  
成立 <br> dsung lih <br>	<br> To accomplish <br> <br> <hr> <br>  <br>  
組成 <br> tsú dsung <br>	<br> To accomplish <br> <br> <hr> <br>  <br>  
解決 <br> kyá kyöh <br>	<br> To determine, to decide <br> <br> <hr> <br>  <br>  
解決 <br> ká kyöh <br>	<br> To determine, to decide <br> <br> <hr> <br>  <br>  
議決 <br> nyi kyöh <br>	<br> To decide by consultation <br> <br> <hr> <br>  <br>  
"參謀 <br> ts'en meu <br>"	<br> To aid by counsel <br> <br> <hr> <br>  <br>  
研究 <br> nyin kyeu <br>	<br> To examine, to investigate <br> <br> <hr> <br>  <br>  
調查 <br> diau dsó <br>	<br> To investigate <br> <br> <hr> <br>  <br>  
"暗察 <br> en ts'ah <br>"	<br> To investigate secretly, to spy upon <br> <br> <hr> <br>  <br>  
公佈 <br> kúng pú <br>	<br> To publish, to make known <br> <br> <hr> <br>  <br>  
發標 <br> fah piau <br>	<br> To publish, to make known <br> <br> <hr> <br>  <br>  
發明 <br> fah ming <br>	<br> To publish, to make known <br> <br> <hr> <br>  <br>  
揭曉 <br> kyih hyau <br>	<br> To publish, to make known <br> <br> <hr> <br>  <br>  
声明 <br> sung ming <br>	<br> To manifest, to publish <br> <br> <hr> <br>  <br>  
注重 <br> tsû dsúng <br>	<br> To consider very important <br> <br> <hr> <br>  <br>  
注意 <br> tsû i <br>	<br> To pay particular attention, NB <br> <br> <hr> <br>  <br>  
注目 <br> tsû móh <br>	<br> To pay particular attention (look carefully) <br> <br> <hr> <br>  <br>  
冒險 <br> mau hyin <br>	<br> To venture <br> <br> <hr> <br>  <br>  
"進取 <br> tsing ts'üi <br>"	<br> To advance <br> <br> <hr> <br>  <br>  
"通過 <br> t'úng kú <br>"	<br> To pass, after investigation <br> <br> <hr> <br>  <br>  
商辦 <br> song ban <br>	<br> To manage <br> <br> <hr> <br>  <br>  
"要求 <br> y'au gyeu <br>"	<br> To request, to demand <br> <br> <hr> <br>  <br>  
發給 <br> fah kyih <br>	<br> To give forth, to issue <br> <br> <hr> <br>  <br>  
"驅策 <br> ky'ü ts'uh <br>"	<br> To send <br> <br> <hr> <br>  <br>  
遜位 <br> sung we <br>	<br> To abdicate <br> <br> <hr> <br>  <br>  
"退位 <br> t'e we <br>"	<br> To abdicate <br> <br> <hr> <br>  <br>  
暗殺 <br> en sah <br>	<br> To assassinate <br> <br> <hr> <br>  <br>  
"行刺 <br> háng ts'z <br>"	<br> To assassinate <br> <br> <hr> <br>  <br>  
"放棄 <br> fong ky'i <br>"	<br> To lay down, as an office, to resign <br> <br> <hr> <br>  <br>  
鬧風潮 <br> nau fúng dsau <br>	<br> To raise a disturbance <br> <br> <hr> <br>  <br>  
敗露 <br> bá lú <br>	<br> To be discovered <br> <br> <hr> <br>  <br>  
辨白 <br> bin báh <br>	"<br> To establish one's innocence, to explain <br> <br> <hr> <br>  <br>  "
"奪取 <br> döh ts'ü <br>"	<br> To seize <br> <br> <hr> <br>  <br>  
"侵佔 <br> ts'ing tsin <br>"	<br> To usurp, to seize without right <br> <br> <hr> <br>  <br>  
爭持 <br> tsung dsz <br>	<br> To disagree, to dispute <br> <br> <hr> <br>  <br>  
反對 <br> fan te <br>	<br> To oppose <br> <br> <hr> <br>  <br>  
鑽營 <br> tsön yung <br>	<br> To intrigue for obtaining an object <br> <br> <hr> <br>  <br>  
"優待 <br> y'eu de <br>"	<br> To treat well, complimentary <br> <br> <hr> <br>  <br>  
"拍掌 <br> p'áh tsáng <br>"	<br> To clap the hands, a hand clapping <br> <br> <hr> <br>  <br>  
歡迎 <br> hwen nyung <br>	<br> To welcome, a meeting of welcome <br> <br> <hr> <br>  <br>  
招待 <br> tsau de <br>	<br> To recieve guests or strangers <br> <br> <hr> <br>  <br>  
談心 <br> dan sing <br>	<br> To converse <br> <br> <hr> <br>  <br>  
介紹 <br> kyá zau <br>	<br> To introduce (as one person to another) <br> <br> <hr> <br>  <br>  
"脫帽禮 <br> t'öh mau li <br>"	<br> To lift the hat in salute <br> <br> <hr> <br>  <br>  
握手禮 <br> óh seu li <br>	<br> To shake hands <br> <br> <hr> <br>  <br>  
接吻禮 <br> tsih vung li <br>	<br> To kiss <br> <br> <hr> <br>  <br>  
對待 <br> te de <br>	<br> To reciprocate <br> <br> <hr> <br>  <br>  
"趨時 <br> ts'ü zz <br>"	<br> To keep up with the times (follow fashion) <br> <br> <hr> <br>  <br>  
目的達到 <br> móh tih dah tau <br>	"<br> To attain one's ideal <br> <br> <hr> <br>  <br>  "
對於 <br> te yü <br>	<br> In relation to, attitude towards <br> <br> <hr> <br>  <br>  
關於 <br> kwan yü <br>	<br> To concern oneself with, concerning <br> <br> <hr> <br>  <br>  
